CACGCCCTTAGCTTTGCCC -> ACGCCCTTAGCTTTGCCCT
AATGTTACCCTTATTAATT -> ATGTTACCCTTATTAATTG
GACACGACGGCCTTGGCGC -> ACACGACGGCCTTGGCGCA
GCATTGGCGTCGAACACCT -> CATTGGCGTCGAACACCTC
ACTTGGAGCTACGCGCCGT -> CTTGGAGCTACGCGCCGTA
CCTCGTTAGCCGAGAGGAT -> CTCGTTAGCCGAGAGGATC
TCAGCGACAAGTGAGCGTA -> CAGCGACAAGTGAGCGTAG
ACGTTGTCTGGGAGAGAGC -> CGTTGTCTGGGAGAGAGCC
ACCTCGGTGCCAATTGCAA -> CCTCGGTGCCAATTGCAAC
TACCGTGCCGAGCATCTAG -> ACCGTGCCGAGCATCTAGA
TGAAACGGTGGAGTCTCTG -> GAAACGGTGGAGTCTCTGG
TTAATTTAACGCGTTCAAT -> TAATTTAACGCGTTCAATC
CTATAGCTGAGCTCTTCCA -> TATAGCTGAGCTCTTCCAC
GAGGATCCATGCTGCTGCG -> AGGATCCATGCTGCTGCGG
GACAGGTGCGTGTCAGCGA -> ACAGGTGCGTGTCAGCGAC
GGTCATTCCGTCAGGTATT -> GTCATTCCGTCAGGTATTA
TATTTACGCCTAATGGGAT -> ATTTACGCCTAATGGGATC
CACATTATTTACGCCTAAT -> ACATTATTTACGCCTAATG
CTATATCAGCGCACCCACG -> TATATCAGCGCACCCACGT
AGAGGATCCATGCTGCTGC -> GAGGATCCATGCTGCTGCG
GGCGCTCGACTATACGTAA -> GCGCTCGACTATACGTAAC
AATCACTTACCTATATCAG -> ATCACTTACCTATATCAGC
AAGAGTTGGAGACGGCCTC -> AGAGTTGGAGACGGCCTCG
GTGAGAACTCCACGATGGG -> TGAGAACTCCACGATGGGC
GGGTCCACCTAGGGGAGCT -> GGTCCACCTAGGGGAGCTG
ATGGGATCGATGTGATTGA -> TGGGATCGATGTGATTGAA
CGGAAATAATCTCATTGGT -> GGAAATAATCTCATTGGTT
TGTCAGCGACAAGTGAGCG -> GTCAGCGACAAGTGAGCGT
GTGGCGGTTAATTTAACGC -> TGGCGGTTAATTTAACGCG
ACAAAATCACTTACCTATA -> CAAAATCACTTACCTATAT
ACATAAACAGGTACGATTT -> CATAAACAGGTACGATTTT
GTCTAAAAAAAGCTCTAAA -> TCTAAAAAAAGCTCTAAAT
GCGGTTAATTTAACGCGTT -> CGGTTAATTTAACGCGTTC
GCCTTGCTGTGTGAAGGCC -> CCTTGCTGTGTGAAGGCCC
ATCACCCCTTTCCAATTTT -> TCACCCCTTTCCAATTTTA
AAGGAGTACGACTGTGCAA -> AGGAGTACGACTGTGCAAG
ATAATAAGTATGTCGAGAA -> TAATAAGTATGTCGAGAAT
CTGTGCAAGTCAGGGGAGG -> TGTGCAAGTCAGGGGAGGA
ATCATAACCATACAAAGTG -> TCATAACCATACAAAGTGT
ACGCCCTTAGCTTTGCCCT -> CGCCCTTAGCTTTGCCCTC
TCGACCCGTGACTTTGATC -> CGACCCGTGACTTTGATCA
CCCTCTTGGGTATGACTTC -> CCTCTTGGGTATGACTTCG
GGTATGACTTCGGTAAGGT -> GTATGACTTCGGTAAGGTG
CGGTAAGGTTCGGGCTCCC -> GGTAAGGTTCGGGCTCCCA
CTCGTCGAGGCAGTGCCGT -> TCGTCGAGGCAGTGCCGTC
TAAGGGCGCTCGACTATAC -> AAGGGCGCTCGACTATACG
AAGCTCGCTTTTCTACACT -> AGCTCGCTTTTCTACACTT
GATGAAATAAGTTGCCAGG -> ATGAAATAAGTTGCCAGGG
CCCGCCAGTCACGGCTCGT -> CCGCCAGTCACGGCTCGTA
TACATCACTAGCCGTCGAT -> ACATCACTAGCCGTCGATT
GGTACGATTTTCGACCCGT -> GTACGATTTTCGACCCGTG
GATAGAAGCATTTCGGAGA -> ATAGAAGCATTTCGGAGAT
GATGTTTCCGATTACCTTT -> ATGTTTCCGATTACCTTTG
GACTTCGGTAAGGTCATTC -> ACTTCGGTAAGGTCATTCC
CCTTGCTGTGTGAAGGCCC -> CTTGCTGTGTGAAGGCCCC
GGTGTGCTTCCCGACAGGA -> GTGTGCTTCCCGACAGGAA
GTGCTATTGACTACTCCCA -> TGCTATTGACTACTCCCAT
TGACTTCGGTAAGGTGGTG -> GACTTCGGTAAGGTGGTGT
GTCAGTCCTCGTCGAGGCA -> TCAGTCCTCGTCGAGGCAG
ACCAGTATCCTGTTACTTG -> CCAGTATCCTGTTACTTGG
CGCCGTGACGACAGTAAGC -> GCCGTGACGACAGTAAGCC
TCCGGAAATAATCTCATTG -> CCGGAAATAATCTCATTGG
GCCTTGGCGCAAAATACCA -> CCTTGGCGCAAAATACCAG
ATGACATGATCGTCCAATG -> TGACATGATCGTCCAATGG
CATCAATCTATAGCTGAGC -> ATCAATCTATAGCTGAGCT
TTGGGAAAGTACTTTCATC -> TGGGAAAGTACTTTCATCA
GAGCACGCATAATAAGTAT -> AGCACGCATAATAAGTATG
TTGGTAAGCCTGGGCTGCC -> TGGTAAGCCTGGGCTGCCA
TATGTTCCGTACAACTCCG -> ATGTTCCGTACAACTCCGA
GGACCCTAGAGACGAGCCT -> GACCCTAGAGACGAGCCTT
CATGCGAACACGCTCAGCC -> ATGCGAACACGCTCAGCCC
AGACGGCCTCGATGTTGTA -> GACGGCCTCGATGTTGTAA
ATCCGCTACGATGCCGAGC -> TCCGCTACGATGCCGAGCT
TTAAGAGTTGGAGACGGCC -> TAAGAGTTGGAGACGGCCT
TGACACGACGGCCTTGGCG -> GACACGACGGCCTTGGCGC
CTCGATGTTGTAACCACCA -> TCGATGTTGTAACCACCAT
AATATGTTACTCGGACCCT -> ATATGTTACTCGGACCCTA
TAATGTCCACACCCGAGAT -> AATGTCCACACCCGAGATA
TACGCCAGAGGATTATCAG -> ACGCCAGAGGATTATCAGA
ATTCCGTCAGGTATTACGC -> TTCCGTCAGGTATTACGCC
TGGAGTCTCTGGGTGCTAG -> GGAGTCTCTGGGTGCTAGG
GTCGATTCTAGGGCAGCCA -> TCGATTCTAGGGCAGCCAT
TGCCCTCTTGGGTATGACT -> GCCCTCTTGGGTATGACTT
CTCCCATCGAGGGGTTAGA -> TCCCATCGAGGGGTTAGAC
CCTCCTGCACGGAACAGGC -> CTCCTGCACGGAACAGGCC
TGATTAAGAGTTGGAGACG -> GATTAAGAGTTGGAGACGG
ACTTCGGTAAGGTCATTCC -> CTTCGGTAAGGTCATTCCG
GTAGCCCATTACATCACTA -> TAGCCCATTACATCACTAG
CAGCATCGGCACTACATAG -> AGCATCGGCACTACATAGG
CCACTCGGAATAGAATGAC -> CACTCGGAATAGAATGACA
GGCTCGGAGGTATTGAATG -> GCTCGGAGGTATTGAATGT
ATACAAAGTGTATGGAGAC -> TACAAAGTGTATGGAGACA
GAGCTGGACGCCAACAGCA -> AGCTGGACGCCAACAGCAC
TCACGCCCTCGCGCAGGAT -> CACGCCCTCGCGCAGGATG
ACGAGATTCCAGAATGGTG -> CGAGATTCCAGAATGGTGG
ATAACCATACAAAGTGTAT -> TAACCATACAAAGTGTATG
GTACAACTCCGACACATTA -> TACAACTCCGACACATTAT
GTACACAAGCTCGCTTTTC -> TACACAAGCTCGCTTTTCT
CTATACCGTGCCGAGCATC -> TATACCGTGCCGAGCATCT
GTATGCTAAGGGCGCTCGA -> TATGCTAAGGGCGCTCGAC
TGATACCCAAAGCCCGCCA -> GATACCCAAAGCCCGCCAG
ACTTTCATCAATCTATAGC -> CTTTCATCAATCTATAGCT
TTACTTTGGGGCTCGGAGG -> TACTTTGGGGCTCGGAGGT
TTCTCATGCGAACACGCTC -> TCTCATGCGAACACGCTCA
ACCCGTGACTTTGATCACG -> CCCGTGACTTTGATCACGC
ACCCGAGATATACCTCCAG -> CCCGAGATATACCTCCAGT
CCAGGTGGGGTTTGCGCAG -> CAGGTGGGGTTTGCGCAGC
CTTGAAGCGTACCCGTCCC -> TTGAAGCGTACCCGTCCCG
ACCCAGGTGGGGTTTGCGC -> CCCAGGTGGGGTTTGCGCA
CATGTGCATTGGCGTCGAA -> ATGTGCATTGGCGTCGAAC
CTAGTGCTATTGACTACTC -> TAGTGCTATTGACTACTCC
TTACGCCTAATGGGATCGA -> TACGCCTAATGGGATCGAT
GATCACGCCCTCGCGCAGG -> ATCACGCCCTCGCGCAGGA
CGATGTGATTGAAAACCTC -> GATGTGATTGAAAACCTCG
GAAGTATGACTTCGGTAAG -> AAGTATGACTTCGGTAAGG
TATACGTAACGACAGGTGC -> ATACGTAACGACAGGTGCG
ACCACCATGAGCACGCATA -> CCACCATGAGCACGCATAA
TTTGCCCTCTTGGGTATGA -> TTGCCCTCTTGGGTATGAC
TTAAGGGGAGCCGATTGAC -> TAAGGGGAGCCGATTGACT
CAAAGAACTCTACCTCGGT -> AAAGAACTCTACCTCGGTG
CCCTCGCGCAGGATGAAAT -> CCTCGCGCAGGATGAAATA
ACTTGAAACGGTGGAGTCT -> CTTGAAACGGTGGAGTCTC
TATGACTTCGGTAAGGTGG -> ATGACTTCGGTAAGGTGGT
TCGATCACGCCCTCGCGCA -> CGATCACGCCCTCGCGCAG
AGTATGACTTCGGTAAGGT -> GTATGACTTCGGTAAGGTA
GGAGCTGATTAAGAGTTGG -> GAGCTGATTAAGAGTTGGA
AGCTCGATCACGCCCTCGC -> GCTCGATCACGCCCTCGCG
AGGTGAGAACTCCACGATG -> GGTGAGAACTCCACGATGG
CAACCTAAGTCCACTCGGA -> AACCTAAGTCCACTCGGAA
ACGCCCAGTATAGGCATTA -> CGCCCAGTATAGGCATTAT
TCGAACACCTCCTGCACGG -> CGAACACCTCCTGCACGGA
TGCTATCTCTGCGAGACTT -> GCTATCTCTGCGAGACTTA
CAGTCACGGCTCGTACAAG -> AGTCACGGCTCGTACAAGT
AATAATCTCATTGGTTGGT -> ATAATCTCATTGGTTGGTA
AAGTGAGCGTAGTACACAA -> AGTGAGCGTAGTACACAAG
TCGATGAGTGGTGTGCTTC -> CGATGAGTGGTGTGCTTCC
AGAAATGCAAAAGTGCTTG -> GAAATGCAAAAGTGCTTGA
ATTTCGGAGATGACATGAT -> TTTCGGAGATGACATGATC
TACGATTTTCGACCCGTGA -> ACGATTTTCGACCCGTGAC
ACCAGACATATGTTCCGTA -> CCAGACATATGTTCCGTAC
TGGGGTTTGCGCAGCTCGA -> GGGGTTTGCGCAGCTCGAT
GCTCGTACAAGTCTACATC -> CTCGTACAAGTCTACATCT
CTGGCAAGTCGAGCATTAG -> TGGCAAGTCGAGCATTAGG
ACGACTGTGCAAGTCAGGG -> CGACTGTGCAAGTCAGGGG
AACAGCACACATGTGCATT -> ACAGCACACATGTGCATTG
TAGTGCGCCCGGTATTACG -> AGTGCGCCCGGTATTACGC
TCACTCAGCATCGGCACTA -> CACTCAGCATCGGCACTAC
ACCTTTGTGTCTGGCAAGT -> CCTTTGTGTCTGGCAAGTC
CGATATCTCTCTTTCACGC -> GATATCTCTCTTTCACGCA
TACTTGGAGCTACGCGCCG -> ACTTGGAGCTACGCGCCGT
CGTTAGCCGAGAGGATCCA -> GTTAGCCGAGAGGATCCAT
TTTTCTACACTTTGCCCTG -> TTTCTACACTTTGCCCTGA
CATCCCAGCGAATTAAGGG -> ATCCCAGCGAATTAAGGGG
ATCCTGTTACTTGGAGCTA -> TCCTGTTACTTGGAGCTAC
CTGAGTACTCCAATGATGG -> TGAGTACTCCAATGATGGC
CAGAGGATTAGTGGTACAC -> AGAGGATTAGTGGTACACT
ATCTACCATTCGATATCTC -> TCTACCATTCGATATCTCT
GACTTCGGTAAGGTTCGGG -> ACTTCGGTAAGGTTCGGGC
GCCCCGCCGGTCACACCCC -> CCCCGCCGGTCACACCCCA
TTCACGCATGTGTTTGAAC -> TCACGCATGTGTTTGAACG
AACTGGGTCAAATATGTTA -> ACTGGGTCAAATATGTTAC
GCCATCCTTTTCCGCTGTT -> CCATCCTTTTCCGCTGTTC
ATGATGGCTTTAGGAGAAG -> TGATGGCTTTAGGAGAAGT
TGGCGTCGAACACCTCCTG -> GGCGTCGAACACCTCCTGC
GTCCGTAAGGAGTACGACT -> TCCGTAAGGAGTACGACTG
TTGAAGCGTACCCGTCCCG -> TGAAGCGTACCCGTCCCGT
GGTGTATGACTTCGGTAAG -> GTGTATGACTTCGGTAAGG
TACACTTGTCTAAAAAAAG -> ACACTTGTCTAAAAAAAGC
AGCCGTCGATTCTAGGGCA -> GCCGTCGATTCTAGGGCAG
GCATTTCGGAGATGACATG -> CATTTCGGAGATGACATGA
ACGCCAGAGGATTAGTGGT -> CGCCAGAGGATTAGTGGTA
AGCGTACCCGTCCCGTCAA -> GCGTACCCGTCCCGTCAAT
CGACAGGTGCGTGTCAGCG -> GACAGGTGCGTGTCAGCGA
TGAAGGCCCCGCCGGTCAC -> GAAGGCCCCGCCGGTCACA
TCTCTGGGTGCTAGGCTGC -> CTCTGGGTGCTAGGCTGCT
AGTTGGAGACGGCCTCGAT -> GTTGGAGACGGCCTCGATG
TCGCGCAGGATGAAATAAG -> CGCGCAGGATGAAATAAGT
TGTTTGAACGAAGTTCAGT -> GTTTGAACGAAGTTCAGTC
GGGAGAAATGCAAAAGTGC -> GGAGAAATGCAAAAGTGCT
GACAAGTGAGCGTAGTACA -> ACAAGTGAGCGTAGTACAC
TGCAGTTTTATAGCTAGGG -> GCAGTTTTATAGCTAGGGG
TTCGAGATAGAAGCATTTC -> TCGAGATAGAAGCATTTCG
ATTAGTGGTACACTAATTG -> TTAGTGGTACACTAATTGG
ACTGGGTCAAATATGTTAC -> CTGGGTCAAATATGTTACT
CTTGTCTAAAAAAAGCTCT -> TTGTCTAAAAAAAGCTCTA
GTCAAATATGTTACTCGGA -> TCAAATATGTTACTCGGAC
TGTCAGTCCTCGTCGAGGC -> GTCAGTCCTCGTCGAGGCA
ATCTATAGCTGAGCTCTTC -> TCTATAGCTGAGCTCTTCC
GGACATAAACAGGTACGAT -> GACATAAACAGGTACGATT
TGGAGACAGAGGTGACACG -> GGAGACAGAGGTGACACGA
ACGACGCCCAGTATAGGCA -> CGACGCCCAGTATAGGCAT
AGAGACGAGCCTTCACCGT -> GAGACGAGCCTTCACCGTA
TTGCGCAGCTCGATCACGC -> TGCGCAGCTCGATCACGCC
AGGAAGTCCGTGGGTATAC -> GGAAGTCCGTGGGTATACC
CCAGTATCCTGTTACTTGG -> CAGTATCCTGTTACTTGGA
CCGATTACCTTTGTGTCTG -> CGATTACCTTTGTGTCTGG
GGTTGACACGACGGCCTTG -> GTTGACACGACGGCCTTGG
GGAGCCGATTGACTTGAAA -> GAGCCGATTGACTTGAAAC
GTACACTAATTGGTGGCAA -> TACACTAATTGGTGGCAAC
ATACAGTAACTGTCCGTAA -> TACAGTAACTGTCCGTAAG
CAGCGACAAGTGAGCGTAG -> AGCGACAAGTGAGCGTAGT
AAAAGTGCTTGAAGCGTAC -> AAAGTGCTTGAAGCGTACC
CGAGCCTTCACCGTATGCT -> GAGCCTTCACCGTATGCTG
CCAGACATATGTTCCGTAC -> CAGACATATGTTCCGTACA
CTCTGGGTGCTAGGCTGCT -> TCTGGGTGCTAGGCTGCTA
AGGATCCATGCTGCTGCGG -> GGATCCATGCTGCTGCGGC
ACTGTCATATCACTCAGCA -> CTGTCATATCACTCAGCAT
AAAGCCCGCCAGTCACGGC -> AAGCCCGCCAGTCACGGCT
GATGCCGAGCTGGACGCCA -> ATGCCGAGCTGGACGCCAA
GGCCTTGGCGCAAAATACC -> GCCTTGGCGCAAAATACCA
CTCGCGCAGGATGAAATAA -> TCGCGCAGGATGAAATAAG
TATACCAGTATCCTGTTAC -> ATACCAGTATCCTGTTACT
TTGCAACGGTGGTAGCCCA -> TGCAACGGTGGTAGCCCAT
CGAGCATCTAGAACTGTCA -> GAGCATCTAGAACTGTCAT
GAGGTATTGAATGTTACCC -> AGGTATTGAATGTTACCCT
TTCCGCTGTTCGAGATAGA -> TCCGCTGTTCGAGATAGAA
ATGTTAGAGCCAATGGGGC -> TGTTAGAGCCAATGGGGCC
GCCCTCTTGGGTATGACTT -> CCCTCTTGGGTATGACTTC
ACAGAGGTGACACGAGATT -> CAGAGGTGACACGAGATTC
CCTTTTCCGCTGTTCGAGA -> CTTTTCCGCTGTTCGAGAT
TTGAATGTTACCCTTATTA -> TGAATGTTACCCTTATTAA
TACCATTCGATATCTCTCT -> ACCATTCGATATCTCTCTT
AGTGTATGGAGACAGAGGT -> GTGTATGGAGACAGAGGTG
GCCCAGTATAGGCATTATC -> CCCAGTATAGGCATTATCA
TCTCTGCGAGACTTACTTT -> CTCTGCGAGACTTACTTTG
TGTCCACACCCGAGATATA -> GTCCACACCCGAGATATAC
CTGTGTGAAGGCCCCGCCG -> TGTGTGAAGGCCCCGCCGG
GCACGCATAATAAGTATGT -> CACGCATAATAAGTATGTC
GGTAAGGTTCGGGCTCCCA -> GTAAGGTTCGGGCTCCCAG
GAGATATACCTCCAGTGGG -> AGATATACCTCCAGTGGGT
CTCCAGTGGGTCATCCCAG -> TCCAGTGGGTCATCCCAGC
ATCCCAGCGAATTAAGGGG -> TCCCAGCGAATTAAGGGGA
GTGGCATTACGCCGTGACG -> TGGCATTACGCCGTGACGA
TCGAGGCAGTGCCGTCCGG -> CGAGGCAGTGCCGTCCGGA
GGTGGCAACCTAAGTCCAC -> GTGGCAACCTAAGTCCACT
CCCTTTCCAATTTTAACCT -> CCTTTCCAATTTTAACCTA
CCTGTTACTTGGAGCTACG -> CTGTTACTTGGAGCTACGC
GCCGAGAGGATCCATGCTG -> CCGAGAGGATCCATGCTGC
CGTCATGGAAGGTCCTGGA -> GTCATGGAAGGTCCTGGAA
ACTTCGGTAAGGTGGTGTA -> CTTCGGTAAGGTGGTGTAT
CGGTTGAGACAAAATCACT -> GGTTGAGACAAAATCACTT
GGTGGCATTACGCCGTGAC -> GTGGCATTACGCCGTGACG
GTCCAATGGTTGACACGAC -> TCCAATGGTTGACACGACG
TGAGGTCACCGCTACGTTG -> GAGGTCACCGCTACGTTGT
AAGGTATCTCTAGGTCGTA -> AGGTATCTCTAGGTCGTAT
GACAAAATCACTTACCTAT -> ACAAAATCACTTACCTATA
CAGTTTTATAGCTAGGGGG -> AGTTTTATAGCTAGGGGGG
GAACGAAGTTCAGTCAAAA -> AACGAAGTTCAGTCAAAAC
GGAAAGTACTTTCATCAAT -> GAAAGTACTTTCATCAATC
AGACATATGTTCCGTACAA -> GACATATGTTCCGTACAAC
CCCATTACATCACTAGCCG -> CCATTACATCACTAGCCGT
CGGGCTCCCAGTATTACGC -> GGGCTCCCAGTATTACGCC
CACCATGAGCACGCATAAT -> ACCATGAGCACGCATAATA
CGCGGTGGCGGTTAATTTA -> GCGGTGGCGGTTAATTTAA
TATGACTTCGGTAAGGTTC -> ATGACTTCGGTAAGGTTCG
ATCAGCGCACCCACGTGAA -> TCAGCGCACCCACGTGAAT
ACTCCAATGATGGCTTTAG -> CTCCAATGATGGCTTTAGG
TGCACGGAACAGGCCTTGC -> GCACGGAACAGGCCTTGCT
AGGCCTTGCTGTGTGAAGG -> GGCCTTGCTGTGTGAAGGC
TAGCCCATTACATCACTAG -> AGCCCATTACATCACTAGC
CGTCAGGTATTACGCCAGA -> GTCAGGTATTACGCCAGAG
TGTTACTTGGAGCTACGCG -> GTTACTTGGAGCTACGCGC
TTCGGAGATGACATGATCG -> TCGGAGATGACATGATCGT
GGAATACCCAGGTGGGGTT -> GAATACCCAGGTGGGGTTT
GTTACCCTTATTAATTGAT -> TTACCCTTATTAATTGATA
TTCGGTAAGGTTCGGGCTC -> TCGGTAAGGTTCGGGCTCC
TTCCGTCAGGTATTACGCC -> TCCGTCAGGTATTACGCCA
TTCGATATCTCTCTTTCAC -> TCGATATCTCTCTTTCACG
CCCATAACTGGGTCAAATA -> CCATAACTGGGTCAAATAT
ACCGATTGAATGCGGTATG -> CCGATTGAATGCGGTATGC
AAAAAAAGCTCTAAATGCG -> AAAAAAGCTCTAAATGCGG
TACACAAGCTCGCTTTTCT -> ACACAAGCTCGCTTTTCTA
CTAAATGCGGTTTATTTCT -> TAAATGCGGTTTATTTCTC
TGCTGATTGCCTTTGCCAT -> GCTGATTGCCTTTGCCATC
GCCTCGATGTTGTAACCAC -> CCTCGATGTTGTAACCACC
TTTCGGCATGTTAGAGCCA -> TTCGGCATGTTAGAGCCAA
GGAACAGGCCTTGCTGTGT -> GAACAGGCCTTGCTGTGTG
AGAGGATTATCAGACTGTG -> GAGGATTATCAGACTGTGA
CACGGAACAGGCCTTGCTG -> ACGGAACAGGCCTTGCTGT
ACATGTGCATTGGCGTCGA -> CATGTGCATTGGCGTCGAA
CCTCGCGCAGGATGAAATA -> CTCGCGCAGGATGAAATAA
CAGACTGTGAACAATAGGT -> AGACTGTGAACAATAGGTG
AAATAAGTTGCCAGGGTGG -> AATAAGTTGCCAGGGTGGC
TCCGCTGTTCGAGATAGAA -> CCGCTGTTCGAGATAGAAG
AAGCCTGGGCTGCCACGCT -> AGCCTGGGCTGCCACGCTA
GGTTGGTAAGCCTGGGCTG -> GTTGGTAAGCCTGGGCTGC
CATCACCCCTTTCCAATTT -> ATCACCCCTTTCCAATTTT
CGATGAGTGGTGTGCTTCC -> GATGAGTGGTGTGCTTCCC
GGTATTACGCCAGAGGATT -> GTATTACGCCAGAGGATTA,GTATTACGCCAGAGGATTA
GACATGATCGTCCAATGGT -> ACATGATCGTCCAATGGTT
CGCTCGACTATACGTAACG -> GCTCGACTATACGTAACGA
CGAGACTTACTTTGGGGCT -> GAGACTTACTTTGGGGCTC
GTAAGGTCATTCCGTCAGG -> TAAGGTCATTCCGTCAGGT
CTTAGCAAGAAATCTCGAC -> TTAGCAAGAAATCTCGACC
GGTTGAGACAAAATCACTT -> GTTGAGACAAAATCACTTA
CTACTCCCATCGAGGGGTT -> TACTCCCATCGAGGGGTTA
ATCTCGACCACAAAGAACT -> TCTCGACCACAAAGAACTC
ATGTCCACACCCGAGATAT -> TGTCCACACCCGAGATATA
CTGATTAAGAGTTGGAGAC -> TGATTAAGAGTTGGAGACG
CGTATGACTTCGGTAAGGT -> GTATGACTTCGGTAAGGTC
CGTGCGGGTCCACCTAGGG -> GTGCGGGTCCACCTAGGGG
ACCCCATAACTGGGTCAAA -> CCCCATAACTGGGTCAAAT
CCAATTGCAACGGTGGTAG -> CAATTGCAACGGTGGTAGC
AAGTATACAGTAACTGTCC -> AGTATACAGTAACTGTCCG
CTCGGAATAGAATGACACT -> TCGGAATAGAATGACACTT
GCTCGGAGGTATTGAATGT -> CTCGGAGGTATTGAATGTT
ATTCATCCCTTATTGGGCC -> TTCATCCCTTATTGGGCCC
TTCCCGACAGGAAGTCCGT -> TCCCGACAGGAAGTCCGTG
GCACCCACGTGAATTCATC -> CACCCACGTGAATTCATCC
CTACCATTCGATATCTCTC -> TACCATTCGATATCTCTCT
CCCGCCGGTCACACCCCAT -> CCGCCGGTCACACCCCATA
GACGCCCAGTATAGGCATT -> ACGCCCAGTATAGGCATTA
TATTAATTGATACCCAAAG -> ATTAATTGATACCCAAAGC
GGGGAGCTGATTAAGAGTT -> GGGAGCTGATTAAGAGTTG
CCTAGGGGAGCTGATTAAG -> CTAGGGGAGCTGATTAAGA
ATGTGTTTGAACGAAGTTC -> TGTGTTTGAACGAAGTTCA
TAGCAAGAAATCTCGACCA -> AGCAAGAAATCTCGACCAC
AACACCTCCTGCACGGAAC -> ACACCTCCTGCACGGAACA
CTGTTCGAGATAGAAGCAT -> TGTTCGAGATAGAAGCATT
TTAGCCGAGAGGATCCATG -> TAGCCGAGAGGATCCATGC
CTTTGCCCTCTTGGGTATG -> TTTGCCCTCTTGGGTATGA
TATGCAGTTTTATAGCTAG -> ATGCAGTTTTATAGCTAGG
GTGCAAGTCAGGGGAGGAC -> TGCAAGTCAGGGGAGGACC
GAGAGAGCCGGTTGAGACA -> AGAGAGCCGGTTGAGACAA
ACCTAGGGGAGCTGATTAA -> CCTAGGGGAGCTGATTAAG
TACCCGTCCCGTCAATTAC -> ACCCGTCCCGTCAATTACA
TCGGACCCTAGAGACGAGC -> CGGACCCTAGAGACGAGCC
GTCAATTACACGACGCCCA -> TCAATTACACGACGCCCAG
CATCCCTTATTGGGCCCCC -> ATCCCTTATTGGGCCCCCC
AGTCAAAACCCACCCTTAG -> GTCAAAACCCACCCTTAGC
ATGCCGAGCTGGACGCCAA -> TGCCGAGCTGGACGCCAAC
AGGGGGGAGAAATGCAAAA -> GGGGGGAGAAATGCAAAAG
GTCATTCCGTCAGGTATTA -> TCATTCCGTCAGGTATTAC
GTGCATTGGCGTCGAACAC -> TGCATTGGCGTCGAACACC
CTAGGCTGCTATCTCTGCG -> TAGGCTGCTATCTCTGCGA
CTACCTCGGTGCCAATTGC -> TACCTCGGTGCCAATTGCA
CGATTGACTTGAAACGGTG -> GATTGACTTGAAACGGTGG
GATCGTCCAATGGTTGACA -> ATCGTCCAATGGTTGACAC
GGGCCCCCCTAAAGTATGC -> GGCCCCCCTAAAGTATGCT
CGGTAAGGTATCTCTAGGT -> GGTAAGGTATCTCTAGGTC
TCATCCCAGCGAATTAAGG -> CATCCCAGCGAATTAAGGG
GTTTTATAGCTAGGGGGGA -> TTTTATAGCTAGGGGGGAG
GGGCGTAAGTATACAGTAA -> GGCGTAAGTATACAGTAAC
CGACAGTAAGCCAACTTTA -> GACAGTAAGCCAACTTTAT
TTGAACGAAGTTCAGTCAA -> TGAACGAAGTTCAGTCAAA
AAGTTCAGTCAAAACCCAC -> AGTTCAGTCAAAACCCACC
AAAGAACTCTACCTCGGTG -> AAGAACTCTACCTCGGTGC
CCTTAGCAAGAAATCTCGA -> CTTAGCAAGAAATCTCGAC
CGATTTTCGACCCGTGACT -> GATTTTCGACCCGTGACTT
CGCGCGGTGGCGGTTAATT -> GCGCGGTGGCGGTTAATTT
GCGCTCGACTATACGTAAC -> CGCTCGACTATACGTAACG
ACTTGTCTAAAAAAAGCTC -> CTTGTCTAAAAAAAGCTCT
CGAGCATTAGGACATAAAC -> GAGCATTAGGACATAAACA
TAACCTATACCGTGCCGAG -> AACCTATACCGTGCCGAGC
CGGCTATCGATGAGTGGTG -> GGCTATCGATGAGTGGTGT
CCGATGTTTCCGATTACCT -> CGATGTTTCCGATTACCTT
CATAAACAGGTACGATTTT -> ATAAACAGGTACGATTTTC
GATTGAATGCGGTATGCAG -> ATTGAATGCGGTATGCAGT
ATGTTTCCGATTACCTTTG -> TGTTTCCGATTACCTTTGT
TCCCGTCAATTACACGACG -> CCCGTCAATTACACGACGC
GCGCAGGATGAAATAAGTT -> CGCAGGATGAAATAAGTTG
ATTGGTTGGTAAGCCTGGG -> TTGGTTGGTAAGCCTGGGC
TCCGCTACGATGCCGAGCT -> CCGCTACGATGCCGAGCTG
TGTGAAGGCCCCGCCGGTC -> GTGAAGGCCCCGCCGGTCA
TCACGCATGTGTTTGAACG -> CACGCATGTGTTTGAACGA
TCGGCACTACATAGGGTTA -> CGGCACTACATAGGGTTAC
TTATTAATTGATACCCAAA -> TATTAATTGATACCCAAAG
GAGGTGACACGAGATTCCA -> AGGTGACACGAGATTCCAG
TCCCAGTATTACGCCAGAG -> CCCAGTATTACGCCAGAGG
GGCACTACATAGGGTTACA -> GCACTACATAGGGTTACAC
CGTTCAATCCGCTACGATG -> GTTCAATCCGCTACGATGC
GTACCCGTCCCGTCAATTA -> TACCCGTCCCGTCAATTAC
AGGGTGGCATTACGCCGTG -> GGGTGGCATTACGCCGTGA
CTCGTTAGCCGAGAGGATC -> TCGTTAGCCGAGAGGATCC
CACTTACCTATATCAGCGC -> ACTTACCTATATCAGCGCA
TTTATTTCTCATGCGAACA -> TTATTTCTCATGCGAACAC
CAGACATATGTTCCGTACA -> AGACATATGTTCCGTACAA
CTAGGGCAGCCATGTCAGT -> TAGGGCAGCCATGTCAGTC
TAGCTGAGCTCTTCCACCG -> AGCTGAGCTCTTCCACCGA
TGAAGCGTACCCGTCCCGT -> GAAGCGTACCCGTCCCGTC
GCCTGGGCTGCCACGCTAC -> CCTGGGCTGCCACGCTACC
GTGTTTGAACGAAGTTCAG -> TGTTTGAACGAAGTTCAGT
CTAGAGACGAGCCTTCACC -> TAGAGACGAGCCTTCACCG
CCATTACATCACTAGCCGT -> CATTACATCACTAGCCGTC
GGAGACAGAGGTGACACGA -> GAGACAGAGGTGACACGAG
AAATCTCGACCACAAAGAA -> AATCTCGACCACAAAGAAC
TACAAAGTGTATGGAGACA -> ACAAAGTGTATGGAGACAG
GACCACAAAGAACTCTACC -> ACCACAAAGAACTCTACCT
AGAGTTGGAGACGGCCTCG -> GAGTTGGAGACGGCCTCGA
TATTGGGAAAGTACTTTCA -> ATTGGGAAAGTACTTTCAT
GTAAGCCTGGGCTGCCACG -> TAAGCCTGGGCTGCCACGC
CACCGATTGAATGCGGTAT -> ACCGATTGAATGCGGTATG
CGCCTAATGGGATCGATGT -> GCCTAATGGGATCGATGTG
GCTGTTCGAGATAGAAGCA -> CTGTTCGAGATAGAAGCAT
CCCCATAACTGGGTCAAAT -> CCCATAACTGGGTCAAATA
CCATAACTGGGTCAAATAT -> CATAACTGGGTCAAATATG
ACACAAGCTCGCTTTTCTA -> CACAAGCTCGCTTTTCTAC
AGAAATCTCGACCACAAAG -> GAAATCTCGACCACAAAGA
AAGTGTATGGAGACAGAGG -> AGTGTATGGAGACAGAGGT
TGACTTTGATCACGCCCTT -> GACTTTGATCACGCCCTTA
GGCCAGCCGCTAATGTCCA -> GCCAGCCGCTAATGTCCAC
TTACGCCAGAGGATTAGTG -> TACGCCAGAGGATTAGTGC,TACGCCAGAGGATTAGTGG
ATTGAATGTTACCCTTATT -> TTGAATGTTACCCTTATTA
GGGAGCTGATTAAGAGTTG -> GGAGCTGATTAAGAGTTGG
TCCTGTTACTTGGAGCTAC -> CCTGTTACTTGGAGCTACG
GCGAATTAAGGGGAGCCGA -> CGAATTAAGGGGAGCCGAT
TTTATAGCTAGGGGGGAGA -> TTATAGCTAGGGGGGAGAA
TTTTAACCTATACCGTGCC -> TTTAACCTATACCGTGCCG
CGCATGTGTTTGAACGAAG -> GCATGTGTTTGAACGAAGT
GAGCTCTTCCACCGATTGA -> AGCTCTTCCACCGATTGAA
TGGAGCTACGCGCCGTATG -> GGAGCTACGCGCCGTATGA
CGTAAGTATACAGTAACTG -> GTAAGTATACAGTAACTGT
GATTAAGAGTTGGAGACGG -> ATTAAGAGTTGGAGACGGC
GCCAGAGGATTAGTGCGCC -> CCAGAGGATTAGTGCGCCC
AAAATACCAGACATATGTT -> AAATACCAGACATATGTTC
GCCGATTGACTTGAAACGG -> CCGATTGACTTGAAACGGT
TCCCTTATTGGGCCCCCCT -> CCCTTATTGGGCCCCCCTA
GACAGTAAGCCAACTTTAT -> ACAGTAAGCCAACTTTATT
TGGGTCATCCCAGCGAATT -> GGGTCATCCCAGCGAATTA
TTATTGGGAAAGTACTTTC -> TATTGGGAAAGTACTTTCA
AATGACACTTGAGGTCACC -> ATGACACTTGAGGTCACCG
TGCTAGGCTGCTATCTCTG -> GCTAGGCTGCTATCTCTGC
CGCGCAGGATGAAATAAGT -> GCGCAGGATGAAATAAGTT
ACGGCCTTGGCGCAAAATA -> CGGCCTTGGCGCAAAATAC
ACACTAATTGGTGGCAACC -> CACTAATTGGTGGCAACCT
ATCACTTACCTATATCAGC -> TCACTTACCTATATCAGCG
ATGGTGGCCAGCCGCTAAT -> TGGTGGCCAGCCGCTAATG
TGGGCGTAAGTATACAGTA -> GGGCGTAAGTATACAGTAA
TGGCATTACGCCGTGACGA -> GGCATTACGCCGTGACGAC
GGAGAGAGCCGGTTGAGAC -> GAGAGAGCCGGTTGAGACA
TTGAATGCGGTATGCAGTT -> TGAATGCGGTATGCAGTTT
TGCCAATTGCAACGGTGGT -> GCCAATTGCAACGGTGGTA
CTACATAGGGTTACACTTG -> TACATAGGGTTACACTTGT
CGATCACGCCCTCGCGCAG -> GATCACGCCCTCGCGCAGG
CCCTTAGCAAGAAATCTCG -> CCTTAGCAAGAAATCTCGA
CCTGCACGGAACAGGCCTT -> CTGCACGGAACAGGCCTTG
TCCGTACAACTCCGACACA -> CCGTACAACTCCGACACAT
CAGCCGCTAATGTCCACAC -> AGCCGCTAATGTCCACACC
CCGGTTGAGACAAAATCAC -> CGGTTGAGACAAAATCACT
AGGCAGTGCCGTCCGGAAA -> GGCAGTGCCGTCCGGAAAT
ATTACGCCAGAGGATTATC -> TTACGCCAGAGGATTATCA
TCCGTAAGGAGTACGACTG -> CCGTAAGGAGTACGACTGT
AGCCGATTGACTTGAAACG -> GCCGATTGACTTGAAACGG
TTACTCGGACCCTAGAGAC -> TACTCGGACCCTAGAGACG
GCTCTAAATGCGGTTTATT -> CTCTAAATGCGGTTTATTT
GGTCATCCCAGCGAATTAA -> GTCATCCCAGCGAATTAAG
AGGTGCGTGTCAGCGACAA -> GGTGCGTGTCAGCGACAAG
ACGACAGTAAGCCAACTTT -> CGACAGTAAGCCAACTTTA
TAGAATGACACTTGAGGTC -> AGAATGACACTTGAGGTCA
ATTTTCGACCCGTGACTTT -> TTTTCGACCCGTGACTTTG
ACGCATAATAAGTATGTCG -> CGCATAATAAGTATGTCGA
CGCACCCACGTGAATTCAT -> GCACCCACGTGAATTCATC
CATAGGGTTACACTTGTCT -> ATAGGGTTACACTTGTCTA
ATTATCAGACTGTGAACAA -> TTATCAGACTGTGAACAAT
TAAGGTTCGGGCTCCCAGT -> AAGGTTCGGGCTCCCAGTA
CATTACGCCGTGACGACAG -> ATTACGCCGTGACGACAGT
GGGAAAGTACTTTCATCAA -> GGAAAGTACTTTCATCAAT
GCAACGGTGGTAGCCCATT -> CAACGGTGGTAGCCCATTA
GAATGCGGTATGCAGTTTT -> AATGCGGTATGCAGTTTTA
TATTACGCCAGAGGATTAT -> ATTACGCCAGAGGATTATC,ATTACGCCAGAGGATTATA
AGGGCGCTCGACTATACGT -> GGGCGCTCGACTATACGTA
GACGCCAACAGCACACATG -> ACGCCAACAGCACACATGT
AGGGGAGGACCGTCATGGA -> GGGGAGGACCGTCATGGAA
CGGAGGTATTGAATGTTAC -> GGAGGTATTGAATGTTACC
ATATCAGCGCACCCACGTG -> TATCAGCGCACCCACGTGA
TGACACTTGAGGTCACCGC -> GACACTTGAGGTCACCGCT
CAATGGTTGACACGACGGC -> AATGGTTGACACGACGGCC
GGTGGGGTTTGCGCAGCTC -> GTGGGGTTTGCGCAGCTCG
TGATTGCCTTTGCCATCCT -> GATTGCCTTTGCCATCCTT
GCTATTGACTACTCCCATC -> CTATTGACTACTCCCATCG
GGTGCCAATTGCAACGGTG -> GTGCCAATTGCAACGGTGG
CCGGTATTACGCCAGAGGA -> CGGTATTACGCCAGAGGAT
ATCAATCTATAGCTGAGCT -> TCAATCTATAGCTGAGCTC
CCCCTAAAGTATGCTAAGG -> CCCTAAAGTATGCTAAGGG
ATGAGTGGTGTGCTTCCCG -> TGAGTGGTGTGCTTCCCGA
GGAAGGTCCTGGAATACCC -> GAAGGTCCTGGAATACCCA
AATTTCGGCATGTTAGAGC -> ATTTCGGCATGTTAGAGCC
TACGCCAGAGGATTAGTGC -> ACGCCAGAGGATTAGTGCG
TCGACTATACGTAACGACA -> CGACTATACGTAACGACAG
TCAGGTATTACGCCAGAGG -> CAGGTATTACGCCAGAGGA
ACAATAGGTGAGAACTCCA -> CAATAGGTGAGAACTCCAC
TGACTTCGGTAAGGTCATT -> GACTTCGGTAAGGTCATTC
GAACAGGCCTTGCTGTGTG -> AACAGGCCTTGCTGTGTGA
TAGAACTGTCATATCACTC -> AGAACTGTCATATCACTCA
AGTACTCCAATGATGGCTT -> GTACTCCAATGATGGCTTT
CGGTATTACGCCAGAGGAT -> GGTATTACGCCAGAGGATT
GTCATATCACTCAGCATCG -> TCATATCACTCAGCATCGG
TGAGCGTAGTACACAAGCT -> GAGCGTAGTACACAAGCTC
CTCTTGGGTATGACTTCGG -> TCTTGGGTATGACTTCGGT
TGTGATTGAAAACCTCGTT -> GTGATTGAAAACCTCGTTA
CTTCGGTAAGGTGGTGTAT -> TTCGGTAAGGTGGTGTATG
CCATCGAGGGGTTAGACCG -> CATCGAGGGGTTAGACCGA
GACCCTAGAGACGAGCCTT -> ACCCTAGAGACGAGCCTTC
GCGCAGCTCGATCACGCCC -> CGCAGCTCGATCACGCCCT
GATTACCTTTGTGTCTGGC -> ATTACCTTTGTGTCTGGCA
AGTCAGGGGAGGACCGTCA -> GTCAGGGGAGGACCGTCAT
TAGTGGTACACTAATTGGT -> AGTGGTACACTAATTGGTG
CATCTACCATTCGATATCT -> ATCTACCATTCGATATCTC
GTATACCAGTATCCTGTTA -> TATACCAGTATCCTGTTAC
CTAGGGGAGCTGATTAAGA -> TAGGGGAGCTGATTAAGAG
ACTCTACCTCGGTGCCAAT -> CTCTACCTCGGTGCCAATT
GCCGGTCACACCCCATAAC -> CCGGTCACACCCCATAACT
CACTTGTCTAAAAAAAGCT -> ACTTGTCTAAAAAAAGCTC
GTCAGGGGAGGACCGTCAT -> TCAGGGGAGGACCGTCATG
TTTCACGCATGTGTTTGAA -> TTCACGCATGTGTTTGAAC
CGCTAATGTCCACACCCGA -> GCTAATGTCCACACCCGAG
CTTGGCGCAAAATACCAGA -> TTGGCGCAAAATACCAGAC
CGTTGTCTGGGAGAGAGCC -> GTTGTCTGGGAGAGAGCCG
GGTTAATTTAACGCGTTCA -> GTTAATTTAACGCGTTCAA
ACGCCAGAGGATTAGTGCG -> CGCCAGAGGATTAGTGCGC
CACTAGCCGTCGATTCTAG -> ACTAGCCGTCGATTCTAGG
TGAACAATAGGTGAGAACT -> GAACAATAGGTGAGAACTC
AATGGGGCCTACGACCCGA -> ATGGGGCCTACGACCCGAT
TGAATTCATCCCTTATTGG -> GAATTCATCCCTTATTGGG
GAGCCAATGGGGCCTACGA -> AGCCAATGGGGCCTACGAC
ATTGACTACTCCCATCGAG -> TTGACTACTCCCATCGAGG
GGCGTAAGTATACAGTAAC -> GCGTAAGTATACAGTAACT
CATTGGCGTCGAACACCTC -> ATTGGCGTCGAACACCTCC
CCGTCAATTACACGACGCC -> CGTCAATTACACGACGCCC
GAGGCAGTGCCGTCCGGAA -> AGGCAGTGCCGTCCGGAAA
ATGACACTTGAGGTCACCG -> TGACACTTGAGGTCACCGC
GCATGTGTTTGAACGAAGT -> CATGTGTTTGAACGAAGTT
GCTCTTCCACCGATTGAAT -> CTCTTCCACCGATTGAATG
AGCCTGGGCTGCCACGCTA -> GCCTGGGCTGCCACGCTAC
GCTAGGCTGCTATCTCTGC -> CTAGGCTGCTATCTCTGCG
CGGTTAATTTAACGCGTTC -> GGTTAATTTAACGCGTTCA
GGATCGATGTGATTGAAAA -> GATCGATGTGATTGAAAAC
GTGACGACAGTAAGCCAAC -> TGACGACAGTAAGCCAACT
CCTCGGTGCCAATTGCAAC -> CTCGGTGCCAATTGCAACG
GTACTCCAATGATGGCTTT -> TACTCCAATGATGGCTTTA
AGTATTACGCCAGAGGATT -> GTATTACGCCAGAGGATTA
ACGCATGTGTTTGAACGAA -> CGCATGTGTTTGAACGAAG
GGTATCTCTAGGTCGTATT -> GTATCTCTAGGTCGTATTA
GAGAGCCGGTTGAGACAAA -> AGAGCCGGTTGAGACAAAA
CTGCTGCGGCTATCGATGA -> TGCTGCGGCTATCGATGAG
CCCTGAGTACTCCAATGAT -> CCTGAGTACTCCAATGATG
GTTGAGACAAAATCACTTA -> TTGAGACAAAATCACTTAC
GCGCACCCACGTGAATTCA -> CGCACCCACGTGAATTCAT
ATGGAAGGTCCTGGAATAC -> TGGAAGGTCCTGGAATACC
ACACTTGTCTAAAAAAAGC -> CACTTGTCTAAAAAAAGCT
GTGTATGGAGACAGAGGTG -> TGTATGGAGACAGAGGTGA
CATCGAGGGGTTAGACCGA -> ATCGAGGGGTTAGACCGAT
CGTATGCTGATTGCCTTTG -> GTATGCTGATTGCCTTTGC
ACTACTCCCATCGAGGGGT -> CTACTCCCATCGAGGGGTT
AAATGCGGTTTATTTCTCA -> AATGCGGTTTATTTCTCAT
TCATAACCATACAAAGTGT -> CATAACCATACAAAGTGTA
GCCGCTAATGTCCACACCC -> CCGCTAATGTCCACACCCG
GTGGTGTATGACTTCGGTA -> TGGTGTATGACTTCGGTAA
GAGTTGGAGACGGCCTCGA -> AGTTGGAGACGGCCTCGAT
TCCAATGGTTGACACGACG -> CCAATGGTTGACACGACGG
TGTGTCTGGCAAGTCGAGC -> GTGTCTGGCAAGTCGAGCA
TAAGTATACAGTAACTGTC -> AAGTATACAGTAACTGTCC
TAAATGCGGTTTATTTCTC -> AAATGCGGTTTATTTCTCA
CGCTACCCTAGTGCTATTG -> GCTACCCTAGTGCTATTGA
AATTTTAACCTATACCGTG -> ATTTTAACCTATACCGTGC
CGCTCAGCCCGTGCGGGTC -> GCTCAGCCCGTGCGGGTCC
GTCCGGAAATAATCTCATT -> TCCGGAAATAATCTCATTG
ATTAGTGCGCCCGGTATTA -> TTAGTGCGCCCGGTATTAC
ATTACATCACTAGCCGTCG -> TTACATCACTAGCCGTCGA
GCCCATTACATCACTAGCC -> CCCATTACATCACTAGCCG
ATCACTAGCCGTCGATTCT -> TCACTAGCCGTCGATTCTA
TCTCGACCACAAAGAACTC -> CTCGACCACAAAGAACTCT
CGAGATTCCAGAATGGTGG -> GAGATTCCAGAATGGTGGC
AGAGGATTAGTGGTACACT -> GAGGATTAGTGGTACACTA
GTAAGGAGTACGACTGTGC -> TAAGGAGTACGACTGTGCA
ACAGTAAGCCAACTTTATT -> CAGTAAGCCAACTTTATTG
GATTGCCTTTGCCATCCTT -> ATTGCCTTTGCCATCCTTT
GACCGTCATGGAAGGTCCT -> ACCGTCATGGAAGGTCCTG
CATCCTTTTCCGCTGTTCG -> ATCCTTTTCCGCTGTTCGA
AACCACCATGAGCACGCAT -> ACCACCATGAGCACGCATA
AGTAAGCCAACTTTATTGG -> GTAAGCCAACTTTATTGGG
GCGCCGTATGACTTCGGTA -> CGCCGTATGACTTCGGTAA
TTCTACACTTTGCCCTGAG -> TCTACACTTTGCCCTGAGT
GTTCCGTACAACTCCGACA -> TTCCGTACAACTCCGACAC
GAAAGTACTTTCATCAATC -> AAAGTACTTTCATCAATCT
AAGGTGGTGTATGACTTCG -> AGGTGGTGTATGACTTCGG
CCCGTCAATTACACGACGC -> CCGTCAATTACACGACGCC
TACGCCAGAGGATTATAAC -> ACGCCAGAGGATTATAACC
GGTAGCCCATTACATCACT -> GTAGCCCATTACATCACTA
AGGTATTACGCCAGAGGAT -> GGTATTACGCCAGAGGATT
TTCCAATTTTAACCTATAC -> TCCAATTTTAACCTATACC
TGAGAACTCCACGATGGGC -> GAGAACTCCACGATGGGCG
ACCTCCTGCACGGAACAGG -> CCTCCTGCACGGAACAGGC
TGCTGCTGCGGCTATCGAT -> GCTGCTGCGGCTATCGATG
GTATGCAGTTTTATAGCTA -> TATGCAGTTTTATAGCTAG
CCTTATTGGGCCCCCCTAA -> CTTATTGGGCCCCCCTAAA
TTCGACCCGTGACTTTGAT -> TCGACCCGTGACTTTGATC
TCGGGCTCCCAGTATTACG -> CGGGCTCCCAGTATTACGC
TCTAAAAAAAGCTCTAAAT -> CTAAAAAAAGCTCTAAATG
CCAGTGGGTCATCCCAGCG -> CAGTGGGTCATCCCAGCGA
GGTTCGGGCTCCCAGTATT -> GTTCGGGCTCCCAGTATTA
AGTATGTCGAGAATTTCGG -> GTATGTCGAGAATTTCGGC
ACAAAGAACTCTACCTCGG -> CAAAGAACTCTACCTCGGT
AGGATGAAATAAGTTGCCA -> GGATGAAATAAGTTGCCAG
CTTTGTGTCTGGCAAGTCG -> TTTGTGTCTGGCAAGTCGA
CATGATCGTCCAATGGTTG -> ATGATCGTCCAATGGTTGA
AAGTATGACTTCGGTAAGG -> AGTATGACTTCGGTAAGGT
AATGCGGTATGCAGTTTTA -> ATGCGGTATGCAGTTTTAT
ACATGATCGTCCAATGGTT -> CATGATCGTCCAATGGTTG
CCGTGCCGAGCATCTAGAA -> CGTGCCGAGCATCTAGAAC
ATTATAACCATCACCCCTT -> TTATAACCATCACCCCTTT
GGTAAGGTGGTGTATGACT -> GTAAGGTGGTGTATGACTT
CGAGAGGATCCATGCTGCT -> GAGAGGATCCATGCTGCTG
AGCGACAAGTGAGCGTAGT -> GCGACAAGTGAGCGTAGTA
CCGGAAATAATCTCATTGG -> CGGAAATAATCTCATTGGT
TTGGGGCTCGGAGGTATTG -> TGGGGCTCGGAGGTATTGA
TGACACGAGATTCCAGAAT -> GACACGAGATTCCAGAATG
CATGGAAGGTCCTGGAATA -> ATGGAAGGTCCTGGAATAC
GTGAACAATAGGTGAGAAC -> TGAACAATAGGTGAGAACT
AGGATTAGTGCGCCCGGTA -> GGATTAGTGCGCCCGGTAT
TCCCGACAGGAAGTCCGTG -> CCCGACAGGAAGTCCGTGG
GGAGGACCGTCATGGAAGG -> GAGGACCGTCATGGAAGGT
AGCCGAGAGGATCCATGCT -> GCCGAGAGGATCCATGCTG
TCGACCACAAAGAACTCTA -> CGACCACAAAGAACTCTAC
GCATAATAAGTATGTCGAG -> CATAATAAGTATGTCGAGA
AATCTATAGCTGAGCTCTT -> ATCTATAGCTGAGCTCTTC
CACCCCATAACTGGGTCAA -> ACCCCATAACTGGGTCAAA
TCTCTTTCACGCATGTGTT -> CTCTTTCACGCATGTGTTT
TCTACATCTACCATTCGAT -> CTACATCTACCATTCGATA
TATAGCTAGGGGGGAGAAA -> ATAGCTAGGGGGGAGAAAT
CACGCTCAGCCCGTGCGGG -> ACGCTCAGCCCGTGCGGGT
TGGCGCAAAATACCAGACA -> GGCGCAAAATACCAGACAT
AAGGCCCCGCCGGTCACAC -> AGGCCCCGCCGGTCACACC
ACCCTAGTGCTATTGACTA -> CCCTAGTGCTATTGACTAC
GGGATCGATGTGATTGAAA -> GGATCGATGTGATTGAAAA
AGATATACCTCCAGTGGGT -> GATATACCTCCAGTGGGTC
CAGTGCCGTCCGGAAATAA -> AGTGCCGTCCGGAAATAAT
ATGTTACCCTTATTAATTG -> TGTTACCCTTATTAATTGA
CCGACACATTATTTACGCC -> CGACACATTATTTACGCCT
CCCTTATTGGGCCCCCCTA -> CCTTATTGGGCCCCCCTAA
TGGTTGGTAAGCCTGGGCT -> GGTTGGTAAGCCTGGGCTG
TATGTCGAGAATTTCGGCA -> ATGTCGAGAATTTCGGCAT
GGGAGCCGATTGACTTGAA -> GGAGCCGATTGACTTGAAA
CCTAGAGACGAGCCTTCAC -> CTAGAGACGAGCCTTCACC
TTCGGTAAGGTCATTCCGT -> TCGGTAAGGTCATTCCGTC
AAGAACTCTACCTCGGTGC -> AGAACTCTACCTCGGTGCC
AACCTAAGTCCACTCGGAA -> ACCTAAGTCCACTCGGAAT
AATAGAATGACACTTGAGG -> ATAGAATGACACTTGAGGT
CAAAAGTGCTTGAAGCGTA -> AAAAGTGCTTGAAGCGTAC
ACAGTAACTGTCCGTAAGG -> CAGTAACTGTCCGTAAGGA
TTTCGGAGATGACATGATC -> TTCGGAGATGACATGATCG
TCGATTCTAGGGCAGCCAT -> CGATTCTAGGGCAGCCATG
GGTGGTAGCCCATTACATC -> GTGGTAGCCCATTACATCA
TCCGTCAGGTATTACGCCA -> CCGTCAGGTATTACGCCAG
CAGCACACATGTGCATTGG -> AGCACACATGTGCATTGGC
TCTCTAGGTCGTATTACGC -> CTCTAGGTCGTATTACGCC
TCCAATGATGGCTTTAGGA -> CCAATGATGGCTTTAGGAG
CCTTTGTGTCTGGCAAGTC -> CTTTGTGTCTGGCAAGTCG
CTGAGCTCTTCCACCGATT -> TGAGCTCTTCCACCGATTG
GCATCGGCACTACATAGGG -> CATCGGCACTACATAGGGT
TTGGAGACGGCCTCGATGT -> TGGAGACGGCCTCGATGTT
ACAGGTGCGTGTCAGCGAC -> CAGGTGCGTGTCAGCGACA
ACTGTGCAAGTCAGGGGAG -> CTGTGCAAGTCAGGGGAGG
GAACACGCTCAGCCCGTGC -> AACACGCTCAGCCCGTGCG
TGTCTAAAAAAAGCTCTAA -> GTCTAAAAAAAGCTCTAAA
TTTCCAATTTTAACCTATA -> TTCCAATTTTAACCTATAC
CGTAACGACAGGTGCGTGT -> GTAACGACAGGTGCGTGTC
AACTTTATTGGGAAAGTAC -> ACTTTATTGGGAAAGTACT
GAACTCTACCTCGGTGCCA -> AACTCTACCTCGGTGCCAA
CAGGGTGGCATTACGCCGT -> AGGGTGGCATTACGCCGTG
TCATTGGTTGGTAAGCCTG -> CATTGGTTGGTAAGCCTGG
CCAAAGCCCGCCAGTCACG -> CAAAGCCCGCCAGTCACGG
CCAGAATGGTGGCCAGCCG -> CAGAATGGTGGCCAGCCGC
GTGTGCTTCCCGACAGGAA -> TGTGCTTCCCGACAGGAAG
CAGGAAGTCCGTGGGTATA -> AGGAAGTCCGTGGGTATAC
GGGTTAGACCGATGTTTCC -> GGTTAGACCGATGTTTCCG
TCAATTACACGACGCCCAG -> CAATTACACGACGCCCAGT
CTTTATTGGGAAAGTACTT -> TTTATTGGGAAAGTACTTT
CTCGACTATACGTAACGAC -> TCGACTATACGTAACGACA
TCGGTGCCAATTGCAACGG -> CGGTGCCAATTGCAACGGT
GTAAGGTATCTCTAGGTCG -> TAAGGTATCTCTAGGTCGT
TCAGCCCGTGCGGGTCCAC -> CAGCCCGTGCGGGTCCACC
TAGGAGAAGTATGACTTCG -> AGGAGAAGTATGACTTCGG
GAAGTCCGTGGGTATACCA -> AAGTCCGTGGGTATACCAG
TGAATGTTACCCTTATTAA -> GAATGTTACCCTTATTAAT
TAGGGTTACACTTGTCTAA -> AGGGTTACACTTGTCTAAA
AGGTCCTGGAATACCCAGG -> GGTCCTGGAATACCCAGGT
GTACTTTCATCAATCTATA -> TACTTTCATCAATCTATAG
CAGGCCTTGCTGTGTGAAG -> AGGCCTTGCTGTGTGAAGG
CTATCTCTGCGAGACTTAC -> TATCTCTGCGAGACTTACT
GCCCTTAGCTTTGCCCTCT -> CCCTTAGCTTTGCCCTCTT
TACGTTGTCTGGGAGAGAG -> ACGTTGTCTGGGAGAGAGC
ATGAAATAAGTTGCCAGGG -> TGAAATAAGTTGCCAGGGT
AGCTGAGCTCTTCCACCGA -> GCTGAGCTCTTCCACCGAT
CTCAGCATCGGCACTACAT -> TCAGCATCGGCACTACATA
GTAACGACAGGTGCGTGTC -> TAACGACAGGTGCGTGTCA
TTTGCCCTGAGTACTCCAA -> TTGCCCTGAGTACTCCAAT
AACAGGTACGATTTTCGAC -> ACAGGTACGATTTTCGACC
TGAGCACGCATAATAAGTA -> GAGCACGCATAATAAGTAT
CAGTAAGCCAACTTTATTG -> AGTAAGCCAACTTTATTGG
GAGCCGATTGACTTGAAAC -> AGCCGATTGACTTGAAACG
GCCGGTTGAGACAAAATCA -> CCGGTTGAGACAAAATCAC
GGGGCTCGGAGGTATTGAA -> GGGCTCGGAGGTATTGAAT
GCAAAATACCAGACATATG -> CAAAATACCAGACATATGT
TTGGGCCCCCCTAAAGTAT -> TGGGCCCCCCTAAAGTATG
TATCTCTAGGTCGTATTAC -> ATCTCTAGGTCGTATTACG
CGCCCGGTATTACGCCAGA -> GCCCGGTATTACGCCAGAG
GGTCAAATATGTTACTCGG -> GTCAAATATGTTACTCGGA
TATCAGACTGTGAACAATA -> ATCAGACTGTGAACAATAG
TGTCTGGGAGAGAGCCGGT -> GTCTGGGAGAGAGCCGGTT
TACGCCAGAGGATTAGTGG -> ACGCCAGAGGATTAGTGGT
TATGCTGATTGCCTTTGCC -> ATGCTGATTGCCTTTGCCA
AAAGTACTTTCATCAATCT -> AAGTACTTTCATCAATCTA
AAGGTTCGGGCTCCCAGTA -> AGGTTCGGGCTCCCAGTAT
CTGGGTGCTAGGCTGCTAT -> TGGGTGCTAGGCTGCTATC
ATTACCTTTGTGTCTGGCA -> TTACCTTTGTGTCTGGCAA
GCGAACACGCTCAGCCCGT -> CGAACACGCTCAGCCCGTG
TCCTGCACGGAACAGGCCT -> CCTGCACGGAACAGGCCTT
GTGTGAAGGCCCCGCCGGT -> TGTGAAGGCCCCGCCGGTC
GTCTGGCAAGTCGAGCATT -> TCTGGCAAGTCGAGCATTA
CACGCTACCCTAGTGCTAT -> ACGCTACCCTAGTGCTATT
GGGTTACACTTGTCTAAAA -> GGTTACACTTGTCTAAAAA
TAGCTAGGGGGGAGAAATG -> AGCTAGGGGGGAGAAATGC
CCAGTATAGGCATTATCAT -> CAGTATAGGCATTATCATA
TAACCATCACCCCTTTCCA -> AACCATCACCCCTTTCCAA
GCGGCTATCGATGAGTGGT -> CGGCTATCGATGAGTGGTG
GCAAGTCGAGCATTAGGAC -> CAAGTCGAGCATTAGGACA
CTTGGGTATGACTTCGGTA -> TTGGGTATGACTTCGGTAA
GGAGGTATTGAATGTTACC -> GAGGTATTGAATGTTACCC
GGCATGTTAGAGCCAATGG -> GCATGTTAGAGCCAATGGG
GACCGATGTTTCCGATTAC -> ACCGATGTTTCCGATTACC
GACTATACGTAACGACAGG -> ACTATACGTAACGACAGGT
GCCAACAGCACACATGTGC -> CCAACAGCACACATGTGCA
TCAGACTGTGAACAATAGG -> CAGACTGTGAACAATAGGT
CGAATTAAGGGGAGCCGAT -> GAATTAAGGGGAGCCGATT
GAGATGACATGATCGTCCA -> AGATGACATGATCGTCCAA
TCATCCCTTATTGGGCCCC -> CATCCCTTATTGGGCCCCC
CGAGGGGTTAGACCGATGT -> GAGGGGTTAGACCGATGTT
TTGAAAACCTCGTTAGCCG -> TGAAAACCTCGTTAGCCGA
CTGCTATCTCTGCGAGACT -> TGCTATCTCTGCGAGACTT
CCACCCTTAGCAAGAAATC -> CACCCTTAGCAAGAAATCT
CTCAGCCCGTGCGGGTCCA -> TCAGCCCGTGCGGGTCCAC
TCACTTACCTATATCAGCG -> CACTTACCTATATCAGCGC
GGAAGTCCGTGGGTATACC -> GAAGTCCGTGGGTATACCA
TCACGGCTCGTACAAGTCT -> CACGGCTCGTACAAGTCTA
CAGTCCTCGTCGAGGCAGT -> AGTCCTCGTCGAGGCAGTG
ATACCAGACATATGTTCCG -> TACCAGACATATGTTCCGT
CAAATATGTTACTCGGACC -> AAATATGTTACTCGGACCC
AGACTGTGAACAATAGGTG -> GACTGTGAACAATAGGTGA
AGCACGCATAATAAGTATG -> GCACGCATAATAAGTATGT
ACCCTAGAGACGAGCCTTC -> CCCTAGAGACGAGCCTTCA
GTCGAGCATTAGGACATAA -> TCGAGCATTAGGACATAAA
CACCCTTAGCAAGAAATCT -> ACCCTTAGCAAGAAATCTC
GAGGACCGTCATGGAAGGT -> AGGACCGTCATGGAAGGTC
ATTAATTGATACCCAAAGC -> TTAATTGATACCCAAAGCC
CCAGAGGATTATCAGACTG -> CAGAGGATTATCAGACTGT
GCCCTCGCGCAGGATGAAA -> CCCTCGCGCAGGATGAAAT
GCTGCGGCTATCGATGAGT -> CTGCGGCTATCGATGAGTG
TTGGTGGCAACCTAAGTCC -> TGGTGGCAACCTAAGTCCA
TCCTGGAATACCCAGGTGG -> CCTGGAATACCCAGGTGGG
CCTTTCCAATTTTAACCTA -> CTTTCCAATTTTAACCTAT
TGCCAGGGTGGCATTACGC -> GCCAGGGTGGCATTACGCC
CGGTAAGGTCATTCCGTCA -> GGTAAGGTCATTCCGTCAG
TTATTGGGCCCCCCTAAAG -> TATTGGGCCCCCCTAAAGT
GTGCTTGAAGCGTACCCGT -> TGCTTGAAGCGTACCCGTC
GCCAACTTTATTGGGAAAG -> CCAACTTTATTGGGAAAGT
AAACCCACCCTTAGCAAGA -> AACCCACCCTTAGCAAGAA
ATTACGCCAGAGGATTATA -> TTACGCCAGAGGATTATAA
GTGAGCGTAGTACACAAGC -> TGAGCGTAGTACACAAGCT
TGTATGACTTCGGTAAGGT -> GTATGACTTCGGTAAGGTT
TGTCGAGAATTTCGGCATG -> GTCGAGAATTTCGGCATGT
GGGGAGGACCGTCATGGAA -> GGGAGGACCGTCATGGAAG
TTGGAGCTACGCGCCGTAT -> TGGAGCTACGCGCCGTATG
ATTGCCTTTGCCATCCTTT -> TTGCCTTTGCCATCCTTTT
GCGCGGTGGCGGTTAATTT -> CGCGGTGGCGGTTAATTTA
AACGCGTTCAATCCGCTAC -> ACGCGTTCAATCCGCTACG
TGACTTCGGTAAGGTATCT -> GACTTCGGTAAGGTATCTC
AACTGTCATATCACTCAGC -> ACTGTCATATCACTCAGCA
AAAGTATGCTAAGGGCGCT -> AAGTATGCTAAGGGCGCTC
CTCTAGGTCGTATTACGCC -> TCTAGGTCGTATTACGCCA
AAGCGTACCCGTCCCGTCA -> AGCGTACCCGTCCCGTCAA
AACCTATACCGTGCCGAGC -> ACCTATACCGTGCCGAGCA
CCCTTATTAATTGATACCC -> CCTTATTAATTGATACCCA
CCGATTGAATGCGGTATGC -> CGATTGAATGCGGTATGCA
GATACCCAAAGCCCGCCAG -> ATACCCAAAGCCCGCCAGT
ACCTAAGTCCACTCGGAAT -> CCTAAGTCCACTCGGAATA
CTTTCACGCATGTGTTTGA -> TTTCACGCATGTGTTTGAA
GAATGGTGGCCAGCCGCTA -> AATGGTGGCCAGCCGCTAA
TTATAGCTAGGGGGGAGAA -> TATAGCTAGGGGGGAGAAA
AAATAATCTCATTGGTTGG -> AATAATCTCATTGGTTGGT
GTATGACTTCGGTAAGGTT -> TATGACTTCGGTAAGGTTC
ATTGACTTGAAACGGTGGA -> TTGACTTGAAACGGTGGAG
TAACTGGGTCAAATATGTT -> AACTGGGTCAAATATGTTA
ACCGTGCCGAGCATCTAGA -> CCGTGCCGAGCATCTAGAA
CCGCTACGTTGTCTGGGAG -> CGCTACGTTGTCTGGGAGA
CGGAGATGACATGATCGTC -> GGAGATGACATGATCGTCC
TAAGTATGTCGAGAATTTC -> AAGTATGTCGAGAATTTCG
GGTGGCCAGCCGCTAATGT -> GTGGCCAGCCGCTAATGTC
CGTCCAATGGTTGACACGA -> GTCCAATGGTTGACACGAC
TATGGAGACAGAGGTGACA -> ATGGAGACAGAGGTGACAC
TAATGGGATCGATGTGATT -> AATGGGATCGATGTGATTG
TGTGTTTGAACGAAGTTCA -> GTGTTTGAACGAAGTTCAG
ATTGGGAAAGTACTTTCAT -> TTGGGAAAGTACTTTCATC
ACGACAGGTGCGTGTCAGC -> CGACAGGTGCGTGTCAGCG
CGCTACGTTGTCTGGGAGA -> GCTACGTTGTCTGGGAGAG
GTTGTAACCACCATGAGCA -> TTGTAACCACCATGAGCAC
TGAACGAAGTTCAGTCAAA -> GAACGAAGTTCAGTCAAAA
GAGGATTAGTGGTACACTA -> AGGATTAGTGGTACACTAA
TGGCAACCTAAGTCCACTC -> GGCAACCTAAGTCCACTCG
CGGACCCTAGAGACGAGCC -> GGACCCTAGAGACGAGCCT
CAAAGCCCGCCAGTCACGG -> AAAGCCCGCCAGTCACGGC
GCGTAAGTATACAGTAACT -> CGTAAGTATACAGTAACTG
AGCGCACCCACGTGAATTC -> GCGCACCCACGTGAATTCA
ATCCCTTATTGGGCCCCCC -> TCCCTTATTGGGCCCCCCT
GAACAATAGGTGAGAACTC -> AACAATAGGTGAGAACTCC
TACCAGACATATGTTCCGT -> ACCAGACATATGTTCCGTA
GTTACACTTGTCTAAAAAA -> TTACACTTGTCTAAAAAAA
CGATTCTAGGGCAGCCATG -> GATTCTAGGGCAGCCATGT
AGCCAATGGGGCCTACGAC -> GCCAATGGGGCCTACGACC
CCAGAGGATTAGTGGTACA -> CAGAGGATTAGTGGTACAC
GGGAGGACCGTCATGGAAG -> GGAGGACCGTCATGGAAGG
ATTTTAACCTATACCGTGC -> TTTTAACCTATACCGTGCC
TTTGATCACGCCCTTAGCT -> TTGATCACGCCCTTAGCTT
CGTCGAGGCAGTGCCGTCC -> GTCGAGGCAGTGCCGTCCG
CCGTCCGGAAATAATCTCA -> CGTCCGGAAATAATCTCAT
TCGTATTACGCCAGAGGAT -> CGTATTACGCCAGAGGATT
TTACGCCAGAGGATTATCA -> TACGCCAGAGGATTATCAG
AACGGTGGAGTCTCTGGGT -> ACGGTGGAGTCTCTGGGTG
AAGTCAGGGGAGGACCGTC -> AGTCAGGGGAGGACCGTCA
AAGTATGCTAAGGGCGCTC -> AGTATGCTAAGGGCGCTCG
CGCCAACAGCACACATGTG -> GCCAACAGCACACATGTGC
GCTGATTAAGAGTTGGAGA -> CTGATTAAGAGTTGGAGAC
CTCCCAGTATTACGCCAGA -> TCCCAGTATTACGCCAGAG
TCGAGAATTTCGGCATGTT -> CGAGAATTTCGGCATGTTA
AGAGAGCCGGTTGAGACAA -> GAGAGCCGGTTGAGACAAA
GTGACACGAGATTCCAGAA -> TGACACGAGATTCCAGAAT
AAGGGGAGCCGATTGACTT -> AGGGGAGCCGATTGACTTG
AGTATAGGCATTATCATAA -> GTATAGGCATTATCATAAC
CCGTGACTTTGATCACGCC -> CGTGACTTTGATCACGCCC
TAGCTTTGCCCTCTTGGGT -> AGCTTTGCCCTCTTGGGTA
GAGACGGCCTCGATGTTGT -> AGACGGCCTCGATGTTGTA
GGTCCTGGAATACCCAGGT -> GTCCTGGAATACCCAGGTG
ATTACACGACGCCCAGTAT -> TTACACGACGCCCAGTATA
TGATCACGCCCTTAGCTTT -> GATCACGCCCTTAGCTTTG
AGTGCTTGAAGCGTACCCG -> GTGCTTGAAGCGTACCCGT
CGTATTACGCCAGAGGATT -> GTATTACGCCAGAGGATTA
TCTTGGGTATGACTTCGGT -> CTTGGGTATGACTTCGGTA
CTTCACCGTATGCTGATTG -> TTCACCGTATGCTGATTGC
TCCATGCTGCTGCGGCTAT -> CCATGCTGCTGCGGCTATC
GAGCATCTAGAACTGTCAT -> AGCATCTAGAACTGTCATA
TCATGGAAGGTCCTGGAAT -> CATGGAAGGTCCTGGAATA
GGCCTCGATGTTGTAACCA -> GCCTCGATGTTGTAACCAC
TACATAGGGTTACACTTGT -> ACATAGGGTTACACTTGTC
ATTGGTGGCAACCTAAGTC -> TTGGTGGCAACCTAAGTCC
AGAATGGTGGCCAGCCGCT -> GAATGGTGGCCAGCCGCTA
CTTTGGGGCTCGGAGGTAT -> TTTGGGGCTCGGAGGTATT
GGCCCCCCTAAAGTATGCT -> GCCCCCCTAAAGTATGCTA
CGAGATAGAAGCATTTCGG -> GAGATAGAAGCATTTCGGA
TAGGCTGCTATCTCTGCGA -> AGGCTGCTATCTCTGCGAG
CACGCCCTCGCGCAGGATG -> ACGCCCTCGCGCAGGATGA
CTCGATCACGCCCTCGCGC -> TCGATCACGCCCTCGCGCA
CCCGAGATATACCTCCAGT -> CCGAGATATACCTCCAGTG
ACCATCACCCCTTTCCAAT -> CCATCACCCCTTTCCAATT
TGGTGGCCAGCCGCTAATG -> GGTGGCCAGCCGCTAATGT
TGCGGCTATCGATGAGTGG -> GCGGCTATCGATGAGTGGT
TGACTTCGGTAAGGTTCGG -> GACTTCGGTAAGGTTCGGG
GTCGAACACCTCCTGCACG -> TCGAACACCTCCTGCACGG
AGCATTTCGGAGATGACAT -> GCATTTCGGAGATGACATG
TGGGATCGATGTGATTGAA -> GGGATCGATGTGATTGAAA
CAGCGCACCCACGTGAATT -> AGCGCACCCACGTGAATTC
AAAGTGTATGGAGACAGAG -> AAGTGTATGGAGACAGAGG
ATCACGCCCTTAGCTTTGC -> TCACGCCCTTAGCTTTGCC
CTTTGATCACGCCCTTAGC -> TTTGATCACGCCCTTAGCT
GCCGTCCGGAAATAATCTC -> CCGTCCGGAAATAATCTCA
AACTCCACGATGGGCGTAA -> ACTCCACGATGGGCGTAAG
CCTTAGCTTTGCCCTCTTG -> CTTAGCTTTGCCCTCTTGG
ACGCTCAGCCCGTGCGGGT -> CGCTCAGCCCGTGCGGGTC
TCCACTCGGAATAGAATGA -> CCACTCGGAATAGAATGAC
ATGACTTCGGTAAGGTGGT -> TGACTTCGGTAAGGTGGTG
CCATACAAAGTGTATGGAG -> CATACAAAGTGTATGGAGA
GTGCTAGGCTGCTATCTCT -> TGCTAGGCTGCTATCTCTG
CACACATGTGCATTGGCGT -> ACACATGTGCATTGGCGTC
ACACGCTCAGCCCGTGCGG -> CACGCTCAGCCCGTGCGGG
GTTACTCGGACCCTAGAGA -> TTACTCGGACCCTAGAGAC
GCCAATGGGGCCTACGACC -> CCAATGGGGCCTACGACCC
CTGGACGCCAACAGCACAC -> TGGACGCCAACAGCACACA
ACCTATATCAGCGCACCCA -> CCTATATCAGCGCACCCAC
AGCGTAGTACACAAGCTCG -> GCGTAGTACACAAGCTCGC
CAACTTTATTGGGAAAGTA -> AACTTTATTGGGAAAGTAC
AATTTAACGCGTTCAATCC -> ATTTAACGCGTTCAATCCG
TATCTCTGCGAGACTTACT -> ATCTCTGCGAGACTTACTT
TACGACTGTGCAAGTCAGG -> ACGACTGTGCAAGTCAGGG
GGTCCACCTAGGGGAGCTG -> GTCCACCTAGGGGAGCTGA
TCCCATCGAGGGGTTAGAC -> CCCATCGAGGGGTTAGACC
TGTATGGAGACAGAGGTGA -> GTATGGAGACAGAGGTGAC
CACATGTGCATTGGCGTCG -> ACATGTGCATTGGCGTCGA
CTGTTACTTGGAGCTACGC -> TGTTACTTGGAGCTACGCG
CATTACATCACTAGCCGTC -> ATTACATCACTAGCCGTCG
CTTAGCTTTGCCCTCTTGG -> TTAGCTTTGCCCTCTTGGG
CAATTACACGACGCCCAGT -> AATTACACGACGCCCAGTA
TTACACTTGTCTAAAAAAA -> TACACTTGTCTAAAAAAAG
GAGCTACGCGCCGTATGAC -> AGCTACGCGCCGTATGACT
CTACATCTACCATTCGATA -> TACATCTACCATTCGATAT
CCGCCAGTCACGGCTCGTA -> CGCCAGTCACGGCTCGTAC
ACGATGCCGAGCTGGACGC -> CGATGCCGAGCTGGACGCC
GGAGACGGCCTCGATGTTG -> GAGACGGCCTCGATGTTGT
CCACGATGGGCGTAAGTAT -> CACGATGGGCGTAAGTATA
GACTACTCCCATCGAGGGG -> ACTACTCCCATCGAGGGGT
ACCGTATGCTGATTGCCTT -> CCGTATGCTGATTGCCTTT
TTAACGCGTTCAATCCGCT -> TAACGCGTTCAATCCGCTA
GATATACCTCCAGTGGGTC -> ATATACCTCCAGTGGGTCA
TCTGGCAAGTCGAGCATTA -> CTGGCAAGTCGAGCATTAG
TCGTACAAGTCTACATCTA -> CGTACAAGTCTACATCTAC
ACCCGTCCCGTCAATTACA -> CCCGTCCCGTCAATTACAC
CAATAGGTGAGAACTCCAC -> AATAGGTGAGAACTCCACG
CAGGATGAAATAAGTTGCC -> AGGATGAAATAAGTTGCCA
AGCATCTAGAACTGTCATA -> GCATCTAGAACTGTCATAT
CTCGGAGGTATTGAATGTT -> TCGGAGGTATTGAATGTTA
ACACGAGATTCCAGAATGG -> CACGAGATTCCAGAATGGT
ATGGTTGACACGACGGCCT -> TGGTTGACACGACGGCCTT
CACGCATAATAAGTATGTC -> ACGCATAATAAGTATGTCG
GCTCAGCCCGTGCGGGTCC -> CTCAGCCCGTGCGGGTCCA
GGTGGCGGTTAATTTAACG -> GTGGCGGTTAATTTAACGC
GTATCTCTAGGTCGTATTA -> TATCTCTAGGTCGTATTAC
GGTGAGAACTCCACGATGG -> GTGAGAACTCCACGATGGG
ACCGTCATGGAAGGTCCTG -> CCGTCATGGAAGGTCCTGG
TTCACCGTATGCTGATTGC -> TCACCGTATGCTGATTGCC
ATAGAATGACACTTGAGGT -> TAGAATGACACTTGAGGTC
ACACATGTGCATTGGCGTC -> CACATGTGCATTGGCGTCG
CGGTCACACCCCATAACTG -> GGTCACACCCCATAACTGG
AATTCATCCCTTATTGGGC -> ATTCATCCCTTATTGGGCC
TCACCGCTACGTTGTCTGG -> CACCGCTACGTTGTCTGGG
ACTCCACGATGGGCGTAAG -> CTCCACGATGGGCGTAAGT
TGCAAGTCAGGGGAGGACC -> GCAAGTCAGGGGAGGACCG
GATGTGATTGAAAACCTCG -> ATGTGATTGAAAACCTCGT
GAGATAGAAGCATTTCGGA -> AGATAGAAGCATTTCGGAG
TGCGGTTTATTTCTCATGC -> GCGGTTTATTTCTCATGCG
CAATTTTAACCTATACCGT -> AATTTTAACCTATACCGTG
GACTGTGAACAATAGGTGA -> ACTGTGAACAATAGGTGAG
TTAGCTTTGCCCTCTTGGG -> TAGCTTTGCCCTCTTGGGT
ACGGAACAGGCCTTGCTGT -> CGGAACAGGCCTTGCTGTG
AATGATGGCTTTAGGAGAA -> ATGATGGCTTTAGGAGAAG
GTATACAGTAACTGTCCGT -> TATACAGTAACTGTCCGTA
CTTGAGGTCACCGCTACGT -> TTGAGGTCACCGCTACGTT
AGTGGTGTGCTTCCCGACA -> GTGGTGTGCTTCCCGACAG
GTATGACTTCGGTAAGGTG -> TATGACTTCGGTAAGGTGG
TACAACTCCGACACATTAT -> ACAACTCCGACACATTATT
GTGCTTCCCGACAGGAAGT -> TGCTTCCCGACAGGAAGTC
GATTATCAGACTGTGAACA -> ATTATCAGACTGTGAACAA
ATGCGGTTTATTTCTCATG -> TGCGGTTTATTTCTCATGC
CCAATTTTAACCTATACCG -> CAATTTTAACCTATACCGT
CTACGTTGTCTGGGAGAGA -> TACGTTGTCTGGGAGAGAG
TAGTGCTATTGACTACTCC -> AGTGCTATTGACTACTCCC
TAAGGTGGTGTATGACTTC -> AAGGTGGTGTATGACTTCG
ACTTTGCCCTGAGTACTCC -> CTTTGCCCTGAGTACTCCA
CACTTGAGGTCACCGCTAC -> ACTTGAGGTCACCGCTACG
GAATGACACTTGAGGTCAC -> AATGACACTTGAGGTCACC
GTTGCCAGGGTGGCATTAC -> TTGCCAGGGTGGCATTACG
CAGAGGTGACACGAGATTC -> AGAGGTGACACGAGATTCC
GTGCCGAGCATCTAGAACT -> TGCCGAGCATCTAGAACTG
AGGATTAGTGGTACACTAA -> GGATTAGTGGTACACTAAT
ATACCTCCAGTGGGTCATC -> TACCTCCAGTGGGTCATCC
GCCAGCCGCTAATGTCCAC -> CCAGCCGCTAATGTCCACA
GCCACGCTACCCTAGTGCT -> CCACGCTACCCTAGTGCTA
CCGTAAGGAGTACGACTGT -> CGTAAGGAGTACGACTGTG
TTATCAGACTGTGAACAAT -> TATCAGACTGTGAACAATA
CGACACATTATTTACGCCT -> GACACATTATTTACGCCTA
GCGGGTCCACCTAGGGGAG -> CGGGTCCACCTAGGGGAGC
CCATGAGCACGCATAATAA -> CATGAGCACGCATAATAAG
ATCGGCACTACATAGGGTT -> TCGGCACTACATAGGGTTA
CACAAAGAACTCTACCTCG -> ACAAAGAACTCTACCTCGG
TGCTAAGGGCGCTCGACTA -> GCTAAGGGCGCTCGACTAT
TGACGACAGTAAGCCAACT -> GACGACAGTAAGCCAACTT
TTTGGGGCTCGGAGGTATT -> TTGGGGCTCGGAGGTATTG
TCTTTCACGCATGTGTTTG -> CTTTCACGCATGTGTTTGA
GGAGTCTCTGGGTGCTAGG -> GAGTCTCTGGGTGCTAGGC
ACGCGCCGTATGACTTCGG -> CGCGCCGTATGACTTCGGT
ACACCCCATAACTGGGTCA -> CACCCCATAACTGGGTCAA
AGGTACGATTTTCGACCCG -> GGTACGATTTTCGACCCGT
ATGATCGTCCAATGGTTGA -> TGATCGTCCAATGGTTGAC
AGATAGAAGCATTTCGGAG -> GATAGAAGCATTTCGGAGA
ACTCCGACACATTATTTAC -> CTCCGACACATTATTTACG
AGTTGCCAGGGTGGCATTA -> GTTGCCAGGGTGGCATTAC
AGATGACATGATCGTCCAA -> GATGACATGATCGTCCAAT
AGAAGCATTTCGGAGATGA -> GAAGCATTTCGGAGATGAC
AGGGTTACACTTGTCTAAA -> GGGTTACACTTGTCTAAAA
GCCAGGGTGGCATTACGCC -> CCAGGGTGGCATTACGCCG
GAGGATTATCAGACTGTGA -> AGGATTATCAGACTGTGAA
AAAATCACTTACCTATATC -> AAATCACTTACCTATATCA
TAAGAGTTGGAGACGGCCT -> AAGAGTTGGAGACGGCCTC
CTACGATGCCGAGCTGGAC -> TACGATGCCGAGCTGGACG
CGCCAGAGGATTAGTGCGC -> GCCAGAGGATTAGTGCGCC
TATACCTCCAGTGGGTCAT -> ATACCTCCAGTGGGTCATC
CGATGTTGTAACCACCATG -> GATGTTGTAACCACCATGA
GGCTCCCAGTATTACGCCA -> GCTCCCAGTATTACGCCAG
AGCCCGCCAGTCACGGCTC -> GCCCGCCAGTCACGGCTCG
GTCACACCCCATAACTGGG -> TCACACCCCATAACTGGGT
TACAAGTCTACATCTACCA -> ACAAGTCTACATCTACCAT
TATTGACTACTCCCATCGA -> ATTGACTACTCCCATCGAG
GTTTATTTCTCATGCGAAC -> TTTATTTCTCATGCGAACA
CAGAGGATTAGTGCGCCCG -> AGAGGATTAGTGCGCCCGG
CTCATTGGTTGGTAAGCCT -> TCATTGGTTGGTAAGCCTG
TGCGTGTCAGCGACAAGTG -> GCGTGTCAGCGACAAGTGA
TCGGAATAGAATGACACTT -> CGGAATAGAATGACACTTG
AAATACCAGACATATGTTC -> AATACCAGACATATGTTCC
GGGTCAAATATGTTACTCG -> GGTCAAATATGTTACTCGG
ATGGAGACAGAGGTGACAC -> TGGAGACAGAGGTGACACG
TGCCCTGAGTACTCCAATG -> GCCCTGAGTACTCCAATGA
AGACAAAATCACTTACCTA -> GACAAAATCACTTACCTAT
GATGTTGTAACCACCATGA -> ATGTTGTAACCACCATGAG
GCGTGTCAGCGACAAGTGA -> CGTGTCAGCGACAAGTGAG
TAGACCGATGTTTCCGATT -> AGACCGATGTTTCCGATTA
GATTCCAGAATGGTGGCCA -> ATTCCAGAATGGTGGCCAG
GTGCGGGTCCACCTAGGGG -> TGCGGGTCCACCTAGGGGA
CCCAGGTGGGGTTTGCGCA -> CCAGGTGGGGTTTGCGCAG
GGCGGTTAATTTAACGCGT -> GCGGTTAATTTAACGCGTT
AGGGCAGCCATGTCAGTCC -> GGGCAGCCATGTCAGTCCT
CCGTGGGTATACCAGTATC -> CGTGGGTATACCAGTATCC
TCCGATTACCTTTGTGTCT -> CCGATTACCTTTGTGTCTG
GCGGTATGCAGTTTTATAG -> CGGTATGCAGTTTTATAGC
GGTGCTAGGCTGCTATCTC -> GTGCTAGGCTGCTATCTCT
TTGGCGTCGAACACCTCCT -> TGGCGTCGAACACCTCCTG
GACAGGAAGTCCGTGGGTA -> ACAGGAAGTCCGTGGGTAT
GCTGCTATCTCTGCGAGAC -> CTGCTATCTCTGCGAGACT
CTAGCCGTCGATTCTAGGG -> TAGCCGTCGATTCTAGGGC
TCCACGATGGGCGTAAGTA -> CCACGATGGGCGTAAGTAT
GTATGCTGATTGCCTTTGC -> TATGCTGATTGCCTTTGCC
TCAAATATGTTACTCGGAC -> CAAATATGTTACTCGGACC
CTAAGGGCGCTCGACTATA -> TAAGGGCGCTCGACTATAC
CCACCGATTGAATGCGGTA -> CACCGATTGAATGCGGTAT
ACTTCGGTAAGGTATCTCT -> CTTCGGTAAGGTATCTCTA
GCTTCCCGACAGGAAGTCC -> CTTCCCGACAGGAAGTCCG
GATCGATGTGATTGAAAAC -> ATCGATGTGATTGAAAACC
GACAGAGGTGACACGAGAT -> ACAGAGGTGACACGAGATT
TTGCTGTGTGAAGGCCCCG -> TGCTGTGTGAAGGCCCCGC
CTGTCATATCACTCAGCAT -> TGTCATATCACTCAGCATC
GCTACGCGCCGTATGACTT -> CTACGCGCCGTATGACTTC
CGCCCTTAGCTTTGCCCTC -> GCCCTTAGCTTTGCCCTCT
TTAGCAAGAAATCTCGACC -> TAGCAAGAAATCTCGACCA
ACACTTGAGGTCACCGCTA -> CACTTGAGGTCACCGCTAC
TGGAATACCCAGGTGGGGT -> GGAATACCCAGGTGGGGTT
TAGTACACAAGCTCGCTTT -> AGTACACAAGCTCGCTTTT
AACTCTACCTCGGTGCCAA -> ACTCTACCTCGGTGCCAAT
TTGCCCTGAGTACTCCAAT -> TGCCCTGAGTACTCCAATG
CTGCACGGAACAGGCCTTG -> TGCACGGAACAGGCCTTGC
AGCCGGTTGAGACAAAATC -> GCCGGTTGAGACAAAATCA
GGTGGAGTCTCTGGGTGCT -> GTGGAGTCTCTGGGTGCTA
CATATCACTCAGCATCGGC -> ATATCACTCAGCATCGGCA
TGGTAAGCCTGGGCTGCCA -> GGTAAGCCTGGGCTGCCAC
CGTGACTTTGATCACGCCC -> GTGACTTTGATCACGCCCT
CATTATTTACGCCTAATGG -> ATTATTTACGCCTAATGGG
GTGACTTTGATCACGCCCT -> TGACTTTGATCACGCCCTT
GAAACGGTGGAGTCTCTGG -> AAACGGTGGAGTCTCTGGG
CGCAGCTCGATCACGCCCT -> GCAGCTCGATCACGCCCTC
ATTGATACCCAAAGCCCGC -> TTGATACCCAAAGCCCGCC
GGTGCGTGTCAGCGACAAG -> GTGCGTGTCAGCGACAAGT
AGTTTTATAGCTAGGGGGG -> GTTTTATAGCTAGGGGGGA
TCTGGGAGAGAGCCGGTTG -> CTGGGAGAGAGCCGGTTGA
GGCTTTAGGAGAAGTATGA -> GCTTTAGGAGAAGTATGAC
CGCCAGAGGATTATAACCA -> GCCAGAGGATTATAACCAT
ACTTTGATCACGCCCTTAG -> CTTTGATCACGCCCTTAGC
CCCTAAAGTATGCTAAGGG -> CCTAAAGTATGCTAAGGGC
AGTATCCTGTTACTTGGAG -> GTATCCTGTTACTTGGAGC
CTATTGACTACTCCCATCG -> TATTGACTACTCCCATCGA
AGTCGAGCATTAGGACATA -> GTCGAGCATTAGGACATAA
CCCAAAGCCCGCCAGTCAC -> CCAAAGCCCGCCAGTCACG
ACTTTATTGGGAAAGTACT -> CTTTATTGGGAAAGTACTT
ATCGATGTGATTGAAAACC -> TCGATGTGATTGAAAACCT
GGTTTATTTCTCATGCGAA -> GTTTATTTCTCATGCGAAC
TGTTACTCGGACCCTAGAG -> GTTACTCGGACCCTAGAGA
TATCATAACCATACAAAGT -> ATCATAACCATACAAAGTG
TAACGACAGGTGCGTGTCA -> AACGACAGGTGCGTGTCAG
ATACCCAAAGCCCGCCAGT -> TACCCAAAGCCCGCCAGTC
CCTATATCAGCGCACCCAC -> CTATATCAGCGCACCCACG
CAAGTCAGGGGAGGACCGT -> AAGTCAGGGGAGGACCGTC
CCTAGTGCTATTGACTACT -> CTAGTGCTATTGACTACTC
AGTACGACTGTGCAAGTCA -> GTACGACTGTGCAAGTCAG
CCGATTGACTTGAAACGGT -> CGATTGACTTGAAACGGTG
CTAGGGGGGAGAAATGCAA -> TAGGGGGGAGAAATGCAAA
CAGTGGGTCATCCCAGCGA -> AGTGGGTCATCCCAGCGAA
GACTTCGGTAAGGTATCTC -> ACTTCGGTAAGGTATCTCT
AGTACACAAGCTCGCTTTT -> GTACACAAGCTCGCTTTTC
ATAAACAGGTACGATTTTC -> TAAACAGGTACGATTTTCG
TGGTGTGCTTCCCGACAGG -> GGTGTGCTTCCCGACAGGA
GTTGGAGACGGCCTCGATG -> TTGGAGACGGCCTCGATGT
AGCCGCTAATGTCCACACC -> GCCGCTAATGTCCACACCC
CATCTAGAACTGTCATATC -> ATCTAGAACTGTCATATCA
CCGTACAACTCCGACACAT -> CGTACAACTCCGACACATT
AGCCATGTCAGTCCTCGTC -> GCCATGTCAGTCCTCGTCG
GAGTACGACTGTGCAAGTC -> AGTACGACTGTGCAAGTCA
CCTCGATGTTGTAACCACC -> CTCGATGTTGTAACCACCA
AGTTCAGTCAAAACCCACC -> GTTCAGTCAAAACCCACCC
CCACGTGAATTCATCCCTT -> CACGTGAATTCATCCCTTA
CGGAACAGGCCTTGCTGTG -> GGAACAGGCCTTGCTGTGT
TAACCACCATGAGCACGCA -> AACCACCATGAGCACGCAT
AGGGGTTAGACCGATGTTT -> GGGGTTAGACCGATGTTTC
CGATGCCGAGCTGGACGCC -> GATGCCGAGCTGGACGCCA
ATATGTTCCGTACAACTCC -> TATGTTCCGTACAACTCCG
AGCTGGACGCCAACAGCAC -> GCTGGACGCCAACAGCACA
GCCTTTGCCATCCTTTTCC -> CCTTTGCCATCCTTTTCCG
CACGATGGGCGTAAGTATA -> ACGATGGGCGTAAGTATAC
CTTACCTATATCAGCGCAC -> TTACCTATATCAGCGCACC
ATCGAGGGGTTAGACCGAT -> TCGAGGGGTTAGACCGATG
GGATCCATGCTGCTGCGGC -> GATCCATGCTGCTGCGGCT
GAGCCGGTTGAGACAAAAT -> AGCCGGTTGAGACAAAATC
GGATTATCAGACTGTGAAC -> GATTATCAGACTGTGAACA
GAGGATTATAACCATCACC -> AGGATTATAACCATCACCC
GAGACAGAGGTGACACGAG -> AGACAGAGGTGACACGAGA
CTCCTGCACGGAACAGGCC -> TCCTGCACGGAACAGGCCT
AGAGCCAATGGGGCCTACG -> GAGCCAATGGGGCCTACGA
GGTATTGAATGTTACCCTT -> GTATTGAATGTTACCCTTA
TGATCGTCCAATGGTTGAC -> GATCGTCCAATGGTTGACA
CATATGTTCCGTACAACTC -> ATATGTTCCGTACAACTCC
CCTAAAGTATGCTAAGGGC -> CTAAAGTATGCTAAGGGCG
GGAGAAATGCAAAAGTGCT -> GAGAAATGCAAAAGTGCTT
ACCCTTATTAATTGATACC -> CCCTTATTAATTGATACCC
AGAGGATTAGTGCGCCCGG -> GAGGATTAGTGCGCCCGGT
CTAGGTCGTATTACGCCAG -> TAGGTCGTATTACGCCAGA
CCAATGGGGCCTACGACCC -> CAATGGGGCCTACGACCCG
TGTTACCCTTATTAATTGA -> GTTACCCTTATTAATTGAT
GAATGTTACCCTTATTAAT -> AATGTTACCCTTATTAATT
GCTGATTGCCTTTGCCATC -> CTGATTGCCTTTGCCATCC
CGAGATATACCTCCAGTGG -> GAGATATACCTCCAGTGGG
ACGCTACCCTAGTGCTATT -> CGCTACCCTAGTGCTATTG
GTAAGGTGGTGTATGACTT -> TAAGGTGGTGTATGACTTC
AGACCGATGTTTCCGATTA -> GACCGATGTTTCCGATTAC
GAAGCATTTCGGAGATGAC -> AAGCATTTCGGAGATGACA
GGCATTATCATAACCATAC -> GCATTATCATAACCATACA
AGGTCATTCCGTCAGGTAT -> GGTCATTCCGTCAGGTATT
TCATCAATCTATAGCTGAG -> CATCAATCTATAGCTGAGC
TGGTACACTAATTGGTGGC -> GGTACACTAATTGGTGGCA
GCCGTCGATTCTAGGGCAG -> CCGTCGATTCTAGGGCAGC
CGCCCAGTATAGGCATTAT -> GCCCAGTATAGGCATTATC
CCACCTAGGGGAGCTGATT -> CACCTAGGGGAGCTGATTA
GCTCCCAGTATTACGCCAG -> CTCCCAGTATTACGCCAGA
GCACACATGTGCATTGGCG -> CACACATGTGCATTGGCGT
CCAGTATTACGCCAGAGGA -> CAGTATTACGCCAGAGGAT
GTCGAGGCAGTGCCGTCCG -> TCGAGGCAGTGCCGTCCGG
TCCACACCCGAGATATACC -> CCACACCCGAGATATACCT
GGATTATAACCATCACCCC -> GATTATAACCATCACCCCT
TTAGTGCGCCCGGTATTAC -> TAGTGCGCCCGGTATTACG
TTGGCGCAAAATACCAGAC -> TGGCGCAAAATACCAGACA
CCTGAGTACTCCAATGATG -> CTGAGTACTCCAATGATGG
TAATTGGTGGCAACCTAAG -> AATTGGTGGCAACCTAAGT
CGATTACCTTTGTGTCTGG -> GATTACCTTTGTGTCTGGC
AAGCATTTCGGAGATGACA -> AGCATTTCGGAGATGACAT
TGTTAGAGCCAATGGGGCC -> GTTAGAGCCAATGGGGCCT
ATTAAGGGGAGCCGATTGA -> TTAAGGGGAGCCGATTGAC
TGAGTACTCCAATGATGGC -> GAGTACTCCAATGATGGCT
TCCGTGGGTATACCAGTAT -> CCGTGGGTATACCAGTATC
TTACCTATATCAGCGCACC -> TACCTATATCAGCGCACCC
CCCGTGACTTTGATCACGC -> CCGTGACTTTGATCACGCC
ACCTATACCGTGCCGAGCA -> CCTATACCGTGCCGAGCAT
TCACCGTATGCTGATTGCC -> CACCGTATGCTGATTGCCT
TTACGCCGTGACGACAGTA -> TACGCCGTGACGACAGTAA
TACTCCAATGATGGCTTTA -> ACTCCAATGATGGCTTTAG
CCATTCGATATCTCTCTTT -> CATTCGATATCTCTCTTTC
TGGACGCCAACAGCACACA -> GGACGCCAACAGCACACAT
CTTTGCCATCCTTTTCCGC -> TTTGCCATCCTTTTCCGCT
TCGGTAAGGTATCTCTAGG -> CGGTAAGGTATCTCTAGGT
CGTACCCGTCCCGTCAATT -> GTACCCGTCCCGTCAATTA
ACACCCGAGATATACCTCC -> CACCCGAGATATACCTCCA
AGGCTGCTATCTCTGCGAG -> GGCTGCTATCTCTGCGAGA
AGCTCGCTTTTCTACACTT -> GCTCGCTTTTCTACACTTT
TGCTTGAAGCGTACCCGTC -> GCTTGAAGCGTACCCGTCC
TTATTTCTCATGCGAACAC -> TATTTCTCATGCGAACACG
GGTTTGCGCAGCTCGATCA -> GTTTGCGCAGCTCGATCAC
CGGTTTATTTCTCATGCGA -> GGTTTATTTCTCATGCGAA
TGTGTGAAGGCCCCGCCGG -> GTGTGAAGGCCCCGCCGGT
GCTATCGATGAGTGGTGTG -> CTATCGATGAGTGGTGTGC
GGGTATACCAGTATCCTGT -> GGTATACCAGTATCCTGTT
AAGGTCCTGGAATACCCAG -> AGGTCCTGGAATACCCAGG
CGTGACGACAGTAAGCCAA -> GTGACGACAGTAAGCCAAC
ACAAGCTCGCTTTTCTACA -> CAAGCTCGCTTTTCTACAC
ATAACCATCACCCCTTTCC -> TAACCATCACCCCTTTCCA
TTAACCTATACCGTGCCGA -> TAACCTATACCGTGCCGAG
AACGGTGGTAGCCCATTAC -> ACGGTGGTAGCCCATTACA
ATCAGACTGTGAACAATAG -> TCAGACTGTGAACAATAGG
GTGCGCCCGGTATTACGCC -> TGCGCCCGGTATTACGCCA
CCCCTTTCCAATTTTAACC -> CCCTTTCCAATTTTAACCT
ATCCATGCTGCTGCGGCTA -> TCCATGCTGCTGCGGCTAT
TCGGTAAGGTCATTCCGTC -> CGGTAAGGTCATTCCGTCA
GGTCGTATTACGCCAGAGG -> GTCGTATTACGCCAGAGGA
GCATCTAGAACTGTCATAT -> CATCTAGAACTGTCATATC
GCTGGACGCCAACAGCACA -> CTGGACGCCAACAGCACAC
TCACTAGCCGTCGATTCTA -> CACTAGCCGTCGATTCTAG
GCTCGACTATACGTAACGA -> CTCGACTATACGTAACGAC
TCGGAGGTATTGAATGTTA -> CGGAGGTATTGAATGTTAC
CGCTACGATGCCGAGCTGG -> GCTACGATGCCGAGCTGGA
CTCGTACAAGTCTACATCT -> TCGTACAAGTCTACATCTA
ACCCTTAGCAAGAAATCTC -> CCCTTAGCAAGAAATCTCG
CGCGCCGTATGACTTCGGT -> GCGCCGTATGACTTCGGTA
GTCCGTGGGTATACCAGTA -> TCCGTGGGTATACCAGTAT
GTAACCACCATGAGCACGC -> TAACCACCATGAGCACGCA
TTGACTACTCCCATCGAGG -> TGACTACTCCCATCGAGGG
CAATGGGGCCTACGACCCG -> AATGGGGCCTACGACCCGA
GATGAGTGGTGTGCTTCCC -> ATGAGTGGTGTGCTTCCCG
CTAAAGTATGCTAAGGGCG -> TAAAGTATGCTAAGGGCGC
TCTGCGAGACTTACTTTGG -> CTGCGAGACTTACTTTGGG
AGTGGGTCATCCCAGCGAA -> GTGGGTCATCCCAGCGAAT
GCTTTGCCCTCTTGGGTAT -> CTTTGCCCTCTTGGGTATG
GTCTGGGAGAGAGCCGGTT -> TCTGGGAGAGAGCCGGTTG
CACACCCCATAACTGGGTC -> ACACCCCATAACTGGGTCA
GGCGTCGAACACCTCCTGC -> GCGTCGAACACCTCCTGCA
CGGCATGTTAGAGCCAATG -> GGCATGTTAGAGCCAATGG
GCTTTAGGAGAAGTATGAC -> CTTTAGGAGAAGTATGACT
TATAGCTGAGCTCTTCCAC -> ATAGCTGAGCTCTTCCACC
TCGGCATGTTAGAGCCAAT -> CGGCATGTTAGAGCCAATG
ACGATTTTCGACCCGTGAC -> CGATTTTCGACCCGTGACT
TCTACACTTTGCCCTGAGT -> CTACACTTTGCCCTGAGTA
GAGTCTCTGGGTGCTAGGC -> AGTCTCTGGGTGCTAGGCT
GGCAGCCATGTCAGTCCTC -> GCAGCCATGTCAGTCCTCG
TACGATGCCGAGCTGGACG -> ACGATGCCGAGCTGGACGC
CACTCAGCATCGGCACTAC -> ACTCAGCATCGGCACTACA
ATGTTACTCGGACCCTAGA -> TGTTACTCGGACCCTAGAG
ACTGTCCGTAAGGAGTACG -> CTGTCCGTAAGGAGTACGA
ACGAAGTTCAGTCAAAACC -> CGAAGTTCAGTCAAAACCC
CCTTGGCGCAAAATACCAG -> CTTGGCGCAAAATACCAGA
CATAATAAGTATGTCGAGA -> ATAATAAGTATGTCGAGAA
GAGCCTTCACCGTATGCTG -> AGCCTTCACCGTATGCTGA
ATGGGGCCTACGACCCGAT -> TGGGGCCTACGACCCGATC
GAAATAAGTTGCCAGGGTG -> AAATAAGTTGCCAGGGTGG
TCACCCCTTTCCAATTTTA -> CACCCCTTTCCAATTTTAA
AGAATGACACTTGAGGTCA -> GAATGACACTTGAGGTCAC
CCTGGGCTGCCACGCTACC -> CTGGGCTGCCACGCTACCC
GCCTTCACCGTATGCTGAT -> CCTTCACCGTATGCTGATT
CGGGTCCACCTAGGGGAGC -> GGGTCCACCTAGGGGAGCT
TTACTTGGAGCTACGCGCC -> TACTTGGAGCTACGCGCCG
TACTTTCATCAATCTATAG -> ACTTTCATCAATCTATAGC
ACAGGAAGTCCGTGGGTAT -> CAGGAAGTCCGTGGGTATA
CTCCGACACATTATTTACG -> TCCGACACATTATTTACGC
TACCCAAAGCCCGCCAGTC -> ACCCAAAGCCCGCCAGTCA
CGACGCCCAGTATAGGCAT -> GACGCCCAGTATAGGCATT
CACCGCTACGTTGTCTGGG -> ACCGCTACGTTGTCTGGGA
CCTCGTCGAGGCAGTGCCG -> CTCGTCGAGGCAGTGCCGT
ATACCCAGGTGGGGTTTGC -> TACCCAGGTGGGGTTTGCG
ATTTAACGCGTTCAATCCG -> TTTAACGCGTTCAATCCGC
AATTGCAACGGTGGTAGCC -> ATTGCAACGGTGGTAGCCC
GTTTGCGCAGCTCGATCAC -> TTTGCGCAGCTCGATCACG
TAACCATACAAAGTGTATG -> AACCATACAAAGTGTATGG
ATCTCTCTTTCACGCATGT -> TCTCTCTTTCACGCATGTG
GATTTTCGACCCGTGACTT -> ATTTTCGACCCGTGACTTT
GGGCAGCCATGTCAGTCCT -> GGCAGCCATGTCAGTCCTC
ATCTCTGCGAGACTTACTT -> TCTCTGCGAGACTTACTTT
AGAACTCCACGATGGGCGT -> GAACTCCACGATGGGCGTA
AGGCCCCGCCGGTCACACC -> GGCCCCGCCGGTCACACCC
AATCTCATTGGTTGGTAAG -> ATCTCATTGGTTGGTAAGC
TTCCGTACAACTCCGACAC -> TCCGTACAACTCCGACACA
TCTAGGTCGTATTACGCCA -> CTAGGTCGTATTACGCCAG
GACCCGTGACTTTGATCAC -> ACCCGTGACTTTGATCACG
TCGGAGATGACATGATCGT -> CGGAGATGACATGATCGTC
ACATTATTTACGCCTAATG -> CATTATTTACGCCTAATGG
GATTAGTGGTACACTAATT -> ATTAGTGGTACACTAATTG
ACGATGGGCGTAAGTATAC -> CGATGGGCGTAAGTATACA
GACTTGAAACGGTGGAGTC -> ACTTGAAACGGTGGAGTCT
AAGTCGAGCATTAGGACAT -> AGTCGAGCATTAGGACATA
CCGCTGTTCGAGATAGAAG -> CGCTGTTCGAGATAGAAGC
TAGGTGAGAACTCCACGAT -> AGGTGAGAACTCCACGATG
GCCCTGAGTACTCCAATGA -> CCCTGAGTACTCCAATGAT
ATGACTTCGGTAAGGTTCG -> TGACTTCGGTAAGGTTCGG
ATTGGCGTCGAACACCTCC -> TTGGCGTCGAACACCTCCT
ATAGCTAGGGGGGAGAAAT -> TAGCTAGGGGGGAGAAATG
GTTTGAACGAAGTTCAGTC -> TTTGAACGAAGTTCAGTCA
GTAGTACACAAGCTCGCTT -> TAGTACACAAGCTCGCTTT
TGCGAACACGCTCAGCCCG -> GCGAACACGCTCAGCCCGT
TCCGACACATTATTTACGC -> CCGACACATTATTTACGCC
AAGGTCATTCCGTCAGGTA -> AGGTCATTCCGTCAGGTAT
TGGAAGGTCCTGGAATACC -> GGAAGGTCCTGGAATACCC
AATAGGTGAGAACTCCACG -> ATAGGTGAGAACTCCACGA
AACCTCGTTAGCCGAGAGG -> ACCTCGTTAGCCGAGAGGA
ATGTGCATTGGCGTCGAAC -> TGTGCATTGGCGTCGAACA
AGCCAACTTTATTGGGAAA -> GCCAACTTTATTGGGAAAG
GCCGAGCTGGACGCCAACA -> CCGAGCTGGACGCCAACAG
ATATGTTACTCGGACCCTA -> TATGTTACTCGGACCCTAG
TCCAGTGGGTCATCCCAGC -> CCAGTGGGTCATCCCAGCG
CCGTATGCTGATTGCCTTT -> CGTATGCTGATTGCCTTTG
GAATTTCGGCATGTTAGAG -> AATTTCGGCATGTTAGAGC
GATCACGCCCTTAGCTTTG -> ATCACGCCCTTAGCTTTGC
CAGAGGATTATAACCATCA -> AGAGGATTATAACCATCAC
TAATTTAACGCGTTCAATC -> AATTTAACGCGTTCAATCC
GTCAAAACCCACCCTTAGC -> TCAAAACCCACCCTTAGCA
ATAATCTCATTGGTTGGTA -> TAATCTCATTGGTTGGTAA
GATTAGTGCGCCCGGTATT -> ATTAGTGCGCCCGGTATTA
ATAGGGTTACACTTGTCTA -> TAGGGTTACACTTGTCTAA
TGGTTGACACGACGGCCTT -> GGTTGACACGACGGCCTTG
GAATACCCAGGTGGGGTTT -> AATACCCAGGTGGGGTTTG
CCCAGCGAATTAAGGGGAG -> CCAGCGAATTAAGGGGAGC
CTTACTTTGGGGCTCGGAG -> TTACTTTGGGGCTCGGAGG
TATCACTCAGCATCGGCAC -> ATCACTCAGCATCGGCACT
GATTCTAGGGCAGCCATGT -> ATTCTAGGGCAGCCATGTC
CGGAATAGAATGACACTTG -> GGAATAGAATGACACTTGA
ACGTAACGACAGGTGCGTG -> CGTAACGACAGGTGCGTGT
TAAACAGGTACGATTTTCG -> AAACAGGTACGATTTTCGA
TGTCTGGCAAGTCGAGCAT -> GTCTGGCAAGTCGAGCATT
GTAACTGTCCGTAAGGAGT -> TAACTGTCCGTAAGGAGTA
AGCCCATTACATCACTAGC -> GCCCATTACATCACTAGCC
TCGGTAAGGTTCGGGCTCC -> CGGTAAGGTTCGGGCTCCC
CGGCCTCGATGTTGTAACC -> GGCCTCGATGTTGTAACCA
CCGTGACGACAGTAAGCCA -> CGTGACGACAGTAAGCCAA
TCTAGGGCAGCCATGTCAG -> CTAGGGCAGCCATGTCAGT
GTTTCCGATTACCTTTGTG -> TTTCCGATTACCTTTGTGT
CCGCTAATGTCCACACCCG -> CGCTAATGTCCACACCCGA
AACTGTCCGTAAGGAGTAC -> ACTGTCCGTAAGGAGTACG
TGCCGAGCATCTAGAACTG -> GCCGAGCATCTAGAACTGT
GAGTGGTGTGCTTCCCGAC -> AGTGGTGTGCTTCCCGACA
GCCCGTGCGGGTCCACCTA -> CCCGTGCGGGTCCACCTAG
CGCTTTTCTACACTTTGCC -> GCTTTTCTACACTTTGCCC
TATTTCTCATGCGAACACG -> ATTTCTCATGCGAACACGC
GCTAGGGGGGAGAAATGCA -> CTAGGGGGGAGAAATGCAA
TTGCCCTCTTGGGTATGAC -> TGCCCTCTTGGGTATGACT
CGTAGTACACAAGCTCGCT -> GTAGTACACAAGCTCGCTT
CGTCAATTACACGACGCCC -> GTCAATTACACGACGCCCA
GAGACTTACTTTGGGGCTC -> AGACTTACTTTGGGGCTCG
TTACATCACTAGCCGTCGA -> TACATCACTAGCCGTCGAT
CTGTCCGTAAGGAGTACGA -> TGTCCGTAAGGAGTACGAC
GGTAAGGTCATTCCGTCAG -> GTAAGGTCATTCCGTCAGG
GCAGCTCGATCACGCCCTC -> CAGCTCGATCACGCCCTCG
GGCTGCTATCTCTGCGAGA -> GCTGCTATCTCTGCGAGAC
TTTATTGGGAAAGTACTTT -> TTATTGGGAAAGTACTTTC
AATTGGTGGCAACCTAAGT -> ATTGGTGGCAACCTAAGTC
CCGAGATATACCTCCAGTG -> CGAGATATACCTCCAGTGG
CAAGTCGAGCATTAGGACA -> AAGTCGAGCATTAGGACAT
GATGGCTTTAGGAGAAGTA -> ATGGCTTTAGGAGAAGTAT
CACTCGGAATAGAATGACA -> ACTCGGAATAGAATGACAC
CTACGCGCCGTATGACTTC -> TACGCGCCGTATGACTTCG
GCTACGTTGTCTGGGAGAG -> CTACGTTGTCTGGGAGAGA
CAACGGTGGTAGCCCATTA -> AACGGTGGTAGCCCATTAC
TGTGCAAGTCAGGGGAGGA -> GTGCAAGTCAGGGGAGGAC
ATGCTAAGGGCGCTCGACT -> TGCTAAGGGCGCTCGACTA
TATACCGTGCCGAGCATCT -> ATACCGTGCCGAGCATCTA
TGAATGCGGTATGCAGTTT -> GAATGCGGTATGCAGTTTT
ACGCCAGAGGATTATAACC -> CGCCAGAGGATTATAACCA
AGGTCACCGCTACGTTGTC -> GGTCACCGCTACGTTGTCT
CACTACATAGGGTTACACT -> ACTACATAGGGTTACACTT
CTCTGCGAGACTTACTTTG -> TCTGCGAGACTTACTTTGG
CAATCCGCTACGATGCCGA -> AATCCGCTACGATGCCGAG
AGTATACAGTAACTGTCCG -> GTATACAGTAACTGTCCGT
CAGAATGGTGGCCAGCCGC -> AGAATGGTGGCCAGCCGCT
TGCTATTGACTACTCCCAT -> GCTATTGACTACTCCCATC
ACATCTACCATTCGATATC -> CATCTACCATTCGATATCT
GCATTACGCCGTGACGACA -> CATTACGCCGTGACGACAG
GCGTCGAACACCTCCTGCA -> CGTCGAACACCTCCTGCAC
CCCGGTATTACGCCAGAGG -> CCGGTATTACGCCAGAGGA
GCAGTTTTATAGCTAGGGG -> CAGTTTTATAGCTAGGGGG
ATGCTGATTGCCTTTGCCA -> TGCTGATTGCCTTTGCCAT
GAAGCGTACCCGTCCCGTC -> AAGCGTACCCGTCCCGTCA
ATAGAAGCATTTCGGAGAT -> TAGAAGCATTTCGGAGATG
TACCTCCAGTGGGTCATCC -> ACCTCCAGTGGGTCATCCC
TGGGTATGACTTCGGTAAG -> GGGTATGACTTCGGTAAGG
GTAAGCCAACTTTATTGGG -> TAAGCCAACTTTATTGGGA
ACAACTCCGACACATTATT -> CAACTCCGACACATTATTT
AATTGATACCCAAAGCCCG -> ATTGATACCCAAAGCCCGC
AGTGGTACACTAATTGGTG -> GTGGTACACTAATTGGTGG
CGTGTCAGCGACAAGTGAG -> GTGTCAGCGACAAGTGAGC
TTAGTGGTACACTAATTGG -> TAGTGGTACACTAATTGGT
CCTTTGCCATCCTTTTCCG -> CTTTGCCATCCTTTTCCGC
AAAACCTCGTTAGCCGAGA -> AAACCTCGTTAGCCGAGAG
GCGCCCGGTATTACGCCAG -> CGCCCGGTATTACGCCAGA
TTCTAGGGCAGCCATGTCA -> TCTAGGGCAGCCATGTCAG
CTGGGTCAAATATGTTACT -> TGGGTCAAATATGTTACTC
GCAAAAGTGCTTGAAGCGT -> CAAAAGTGCTTGAAGCGTA
TACCCTAGTGCTATTGACT -> ACCCTAGTGCTATTGACTA
AAGCCAACTTTATTGGGAA -> AGCCAACTTTATTGGGAAA
GAAGTTCAGTCAAAACCCA -> AAGTTCAGTCAAAACCCAC
AGATTCCAGAATGGTGGCC -> GATTCCAGAATGGTGGCCA
GTCTACATCTACCATTCGA -> TCTACATCTACCATTCGAT
TAACGCGTTCAATCCGCTA -> AACGCGTTCAATCCGCTAC
TACACTTTGCCCTGAGTAC -> ACACTTTGCCCTGAGTACT
TATCTCTCTTTCACGCATG -> ATCTCTCTTTCACGCATGT
TTCAGTCAAAACCCACCCT -> TCAGTCAAAACCCACCCTT
TTGAGGTCACCGCTACGTT -> TGAGGTCACCGCTACGTTG
CGTAAGGAGTACGACTGTG -> GTAAGGAGTACGACTGTGC
TCCAGAATGGTGGCCAGCC -> CCAGAATGGTGGCCAGCCG
TTGTAACCACCATGAGCAC -> TGTAACCACCATGAGCACG
TTCATCAATCTATAGCTGA -> TCATCAATCTATAGCTGAG
CATGCTGCTGCGGCTATCG -> ATGCTGCTGCGGCTATCGA
TGGGTATACCAGTATCCTG -> GGGTATACCAGTATCCTGT
TCACGCCCTTAGCTTTGCC -> CACGCCCTTAGCTTTGCCC
ACTCGGAATAGAATGACAC -> CTCGGAATAGAATGACACT
GACGACAGTAAGCCAACTT -> ACGACAGTAAGCCAACTTT
TTTTCCGCTGTTCGAGATA -> TTTCCGCTGTTCGAGATAG
ACATCACTAGCCGTCGATT -> CATCACTAGCCGTCGATTC
ATTCGATATCTCTCTTTCA -> TTCGATATCTCTCTTTCAC
TGCCACGCTACCCTAGTGC -> GCCACGCTACCCTAGTGCT
GAATTCATCCCTTATTGGG -> AATTCATCCCTTATTGGGC
AGTCCTCGTCGAGGCAGTG -> GTCCTCGTCGAGGCAGTGC
GCGAGACTTACTTTGGGGC -> CGAGACTTACTTTGGGGCT
CACGTGAATTCATCCCTTA -> ACGTGAATTCATCCCTTAT
GAGAAATGCAAAAGTGCTT -> AGAAATGCAAAAGTGCTTG
CGACAGGAAGTCCGTGGGT -> GACAGGAAGTCCGTGGGTA
ACTATACGTAACGACAGGT -> CTATACGTAACGACAGGTG
TAACTGTCCGTAAGGAGTA -> AACTGTCCGTAAGGAGTAC
ATTACGCCGTGACGACAGT -> TTACGCCGTGACGACAGTA
GTTCAATCCGCTACGATGC -> TTCAATCCGCTACGATGCC
CCAGGGTGGCATTACGCCG -> CAGGGTGGCATTACGCCGT
ATTGGGCCCCCCTAAAGTA -> TTGGGCCCCCCTAAAGTAT
AATGGTGGCCAGCCGCTAA -> ATGGTGGCCAGCCGCTAAT
CAGTAACTGTCCGTAAGGA -> AGTAACTGTCCGTAAGGAG
GCTCGCTTTTCTACACTTT -> CTCGCTTTTCTACACTTTG
CATTTCGGAGATGACATGA -> ATTTCGGAGATGACATGAT
CGACTGTGCAAGTCAGGGG -> GACTGTGCAAGTCAGGGGA
ACGGCTCGTACAAGTCTAC -> CGGCTCGTACAAGTCTACA
ACGGCCTCGATGTTGTAAC -> CGGCCTCGATGTTGTAACC
ATGTCAGTCCTCGTCGAGG -> TGTCAGTCCTCGTCGAGGC
CAGTATAGGCATTATCATA -> AGTATAGGCATTATCATAA
TCGGTAAGGTGGTGTATGA -> CGGTAAGGTGGTGTATGAC
ACTCAGCATCGGCACTACA -> CTCAGCATCGGCACTACAT
GTGTATGACTTCGGTAAGG -> TGTATGACTTCGGTAAGGT
TTCATCCCTTATTGGGCCC -> TCATCCCTTATTGGGCCCC
AACAATAGGTGAGAACTCC -> ACAATAGGTGAGAACTCCA
GGCCTTGCTGTGTGAAGGC -> GCCTTGCTGTGTGAAGGCC
GGTGGTGTATGACTTCGGT -> GTGGTGTATGACTTCGGTA
TGGGTCAAATATGTTACTC -> GGGTCAAATATGTTACTCG
CACGCATGTGTTTGAACGA -> ACGCATGTGTTTGAACGAA
AGCTCTAAATGCGGTTTAT -> GCTCTAAATGCGGTTTATT
TAAGGTATCTCTAGGTCGT -> AAGGTATCTCTAGGTCGTA
TGCCTTTGCCATCCTTTTC -> GCCTTTGCCATCCTTTTCC
ATTAGGACATAAACAGGTA -> TTAGGACATAAACAGGTAC
CTTTTCCGCTGTTCGAGAT -> TTTTCCGCTGTTCGAGATA
ACTAATTGGTGGCAACCTA -> CTAATTGGTGGCAACCTAA
CACCCGAGATATACCTCCA -> ACCCGAGATATACCTCCAG
TGGTGTATGACTTCGGTAA -> GGTGTATGACTTCGGTAAG
AGGATTATAACCATCACCC -> GGATTATAACCATCACCCC
GGGTCATCCCAGCGAATTA -> GGTCATCCCAGCGAATTAA
ACAGCACACATGTGCATTG -> CAGCACACATGTGCATTGG
GGAGCTACGCGCCGTATGA -> GAGCTACGCGCCGTATGAC
AACACGCTCAGCCCGTGCG -> ACACGCTCAGCCCGTGCGG
ATGCTGCTGCGGCTATCGA -> TGCTGCTGCGGCTATCGAT
AGGTGACACGAGATTCCAG -> GGTGACACGAGATTCCAGA
TGACTTGAAACGGTGGAGT -> GACTTGAAACGGTGGAGTC
CTCTAAATGCGGTTTATTT -> TCTAAATGCGGTTTATTTC
GGATGAAATAAGTTGCCAG -> GATGAAATAAGTTGCCAGG
TGTCCGTAAGGAGTACGAC -> GTCCGTAAGGAGTACGACT
TCCACCGATTGAATGCGGT -> CCACCGATTGAATGCGGTA
CGTCCGGAAATAATCTCAT -> GTCCGGAAATAATCTCATT
ATCTCTAGGTCGTATTACG -> TCTCTAGGTCGTATTACGC
ATACCGTGCCGAGCATCTA -> TACCGTGCCGAGCATCTAG
TTTCCGCTGTTCGAGATAG -> TTCCGCTGTTCGAGATAGA
AGGCATTATCATAACCATA -> GGCATTATCATAACCATAC
GAGGGGTTAGACCGATGTT -> AGGGGTTAGACCGATGTTT
TGCATTGGCGTCGAACACC -> GCATTGGCGTCGAACACCT
TGCCATCCTTTTCCGCTGT -> GCCATCCTTTTCCGCTGTT
CCGTGCGGGTCCACCTAGG -> CGTGCGGGTCCACCTAGGG
CTCGACCACAAAGAACTCT -> TCGACCACAAAGAACTCTA
GCTGTGTGAAGGCCCCGCC -> CTGTGTGAAGGCCCCGCCG
CCCACCCTTAGCAAGAAAT -> CCACCCTTAGCAAGAAATC
GATCCATGCTGCTGCGGCT -> ATCCATGCTGCTGCGGCTA
AGGGGAGCCGATTGACTTG -> GGGGAGCCGATTGACTTGA
CGCGTTCAATCCGCTACGA -> GCGTTCAATCCGCTACGAT
GGAGATGACATGATCGTCC -> GAGATGACATGATCGTCCA
GCTACCCTAGTGCTATTGA -> CTACCCTAGTGCTATTGAC
AGAGGTGACACGAGATTCC -> GAGGTGACACGAGATTCCA
ACCCCTTTCCAATTTTAAC -> CCCCTTTCCAATTTTAACC
GTCGTATTACGCCAGAGGA -> TCGTATTACGCCAGAGGAT
GTGGCCAGCCGCTAATGTC -> TGGCCAGCCGCTAATGTCC
ATAGGTGAGAACTCCACGA -> TAGGTGAGAACTCCACGAT
ACCGATGTTTCCGATTACC -> CCGATGTTTCCGATTACCT
TGCGAGACTTACTTTGGGG -> GCGAGACTTACTTTGGGGC
GTCATCCCAGCGAATTAAG -> TCATCCCAGCGAATTAAGG
AAGTTGCCAGGGTGGCATT -> AGTTGCCAGGGTGGCATTA
CCGTCATGGAAGGTCCTGG -> CGTCATGGAAGGTCCTGGA
GAGGTCACCGCTACGTTGT -> AGGTCACCGCTACGTTGTC
CCGTCAGGTATTACGCCAG -> CGTCAGGTATTACGCCAGA
TCACACCCCATAACTGGGT -> CACACCCCATAACTGGGTC
TTTCGACCCGTGACTTTGA -> TTCGACCCGTGACTTTGAT
GCAAGAAATCTCGACCACA -> CAAGAAATCTCGACCACAA
AAGTCCGTGGGTATACCAG -> AGTCCGTGGGTATACCAGT
ATCACGCCCTCGCGCAGGA -> TCACGCCCTCGCGCAGGAT
AAGTGCTTGAAGCGTACCC -> AGTGCTTGAAGCGTACCCG
TGACATGATCGTCCAATGG -> GACATGATCGTCCAATGGT
ACCCACGTGAATTCATCCC -> CCCACGTGAATTCATCCCT
GGGTTTGCGCAGCTCGATC -> GGTTTGCGCAGCTCGATCA
GGTAAGCCTGGGCTGCCAC -> GTAAGCCTGGGCTGCCACG
GATTATAACCATCACCCCT -> ATTATAACCATCACCCCTT
CGTCGAACACCTCCTGCAC -> GTCGAACACCTCCTGCACG
TATATCAGCGCACCCACGT -> ATATCAGCGCACCCACGTG
ACACCTCCTGCACGGAACA -> CACCTCCTGCACGGAACAG
CCCTAGTGCTATTGACTAC -> CCTAGTGCTATTGACTACT
CCCGTGCGGGTCCACCTAG -> CCGTGCGGGTCCACCTAGG
CATTCCGTCAGGTATTACG -> ATTCCGTCAGGTATTACGC
AGGATTATCAGACTGTGAA -> GGATTATCAGACTGTGAAC
AGGAGTACGACTGTGCAAG -> GGAGTACGACTGTGCAAGT
ACTAGCCGTCGATTCTAGG -> CTAGCCGTCGATTCTAGGG
TACGCCGTGACGACAGTAA -> ACGCCGTGACGACAGTAAG
CTCTTCCACCGATTGAATG -> TCTTCCACCGATTGAATGC
TCAGTCAAAACCCACCCTT -> CAGTCAAAACCCACCCTTA
AGGACATAAACAGGTACGA -> GGACATAAACAGGTACGAT
CGAGCTGGACGCCAACAGC -> GAGCTGGACGCCAACAGCA
GAGACGAGCCTTCACCGTA -> AGACGAGCCTTCACCGTAT
TGGGTGCTAGGCTGCTATC -> GGGTGCTAGGCTGCTATCT
AAAAAAGCTCTAAATGCGG -> AAAAAGCTCTAAATGCGGT
CTCCAATGATGGCTTTAGG -> TCCAATGATGGCTTTAGGA
CCGCTACGATGCCGAGCTG -> CGCTACGATGCCGAGCTGG
AAATATGTTACTCGGACCC -> AATATGTTACTCGGACCCT
GTCCCGTCAATTACACGAC -> TCCCGTCAATTACACGACG
CGCTGTTCGAGATAGAAGC -> GCTGTTCGAGATAGAAGCA
CCGCCGGTCACACCCCATA -> CGCCGGTCACACCCCATAA
GTACAAGTCTACATCTACC -> TACAAGTCTACATCTACCA
GCCATGTCAGTCCTCGTCG -> CCATGTCAGTCCTCGTCGA
GTGGAGTCTCTGGGTGCTA -> TGGAGTCTCTGGGTGCTAG
ACAAAGTGTATGGAGACAG -> CAAAGTGTATGGAGACAGA
CGACTATACGTAACGACAG -> GACTATACGTAACGACAGG
TGTTTCCGATTACCTTTGT -> GTTTCCGATTACCTTTGTG
CGCAGGATGAAATAAGTTG -> GCAGGATGAAATAAGTTGC
CCCACGTGAATTCATCCCT -> CCACGTGAATTCATCCCTT
AATTACACGACGCCCAGTA -> ATTACACGACGCCCAGTAT
TTCGGTAAGGTGGTGTATG -> TCGGTAAGGTGGTGTATGA
CTCGGTGCCAATTGCAACG -> TCGGTGCCAATTGCAACGG
GGCAAGTCGAGCATTAGGA -> GCAAGTCGAGCATTAGGAC
CAGCGAATTAAGGGGAGCC -> AGCGAATTAAGGGGAGCCG
CATTGGTTGGTAAGCCTGG -> ATTGGTTGGTAAGCCTGGG
TGGCTTTAGGAGAAGTATG -> GGCTTTAGGAGAAGTATGA
TATGTTACTCGGACCCTAG -> ATGTTACTCGGACCCTAGA
TCTCTCTTTCACGCATGTG -> CTCTCTTTCACGCATGTGT
GTATGGAGACAGAGGTGAC -> TATGGAGACAGAGGTGACA
GATTGACTTGAAACGGTGG -> ATTGACTTGAAACGGTGGA
ACACGACGGCCTTGGCGCA -> CACGACGGCCTTGGCGCAA
TTCCGATTACCTTTGTGTC -> TCCGATTACCTTTGTGTCT
CGACCCGTGACTTTGATCA -> GACCCGTGACTTTGATCAC
TATACAGTAACTGTCCGTA -> ATACAGTAACTGTCCGTAA
ACTCGGACCCTAGAGACGA -> CTCGGACCCTAGAGACGAG
ATTAAGAGTTGGAGACGGC -> TTAAGAGTTGGAGACGGCC
TATTGGGCCCCCCTAAAGT -> ATTGGGCCCCCCTAAAGTA
GCCGTGACGACAGTAAGCC -> CCGTGACGACAGTAAGCCA
AGAATTTCGGCATGTTAGA -> GAATTTCGGCATGTTAGAG
TACACGACGCCCAGTATAG -> ACACGACGCCCAGTATAGG
CAGTCAAAACCCACCCTTA -> AGTCAAAACCCACCCTTAG
GGTATGCAGTTTTATAGCT -> GTATGCAGTTTTATAGCTA
CTTCGGTAAGGTTCGGGCT -> TTCGGTAAGGTTCGGGCTC
CAATCTATAGCTGAGCTCT -> AATCTATAGCTGAGCTCTT
TCCTTTTCCGCTGTTCGAG -> CCTTTTCCGCTGTTCGAGA
TCGCTTTTCTACACTTTGC -> CGCTTTTCTACACTTTGCC
CCTTATTAATTGATACCCA -> CTTATTAATTGATACCCAA
TTGATCACGCCCTTAGCTT -> TGATCACGCCCTTAGCTTT
TTATCATAACCATACAAAG -> TATCATAACCATACAAAGT
AAGAAATCTCGACCACAAA -> AGAAATCTCGACCACAAAG
GGCTATCGATGAGTGGTGT -> GCTATCGATGAGTGGTGTG
CCAGAGGATTATAACCATC -> CAGAGGATTATAACCATCA
CGCCAGAGGATTATCAGAC -> GCCAGAGGATTATCAGACT
ACCATACAAAGTGTATGGA -> CCATACAAAGTGTATGGAG
GTTGACACGACGGCCTTGG -> TTGACACGACGGCCTTGGC
TGCTGCGGCTATCGATGAG -> GCTGCGGCTATCGATGAGT
GTTGGTAAGCCTGGGCTGC -> TTGGTAAGCCTGGGCTGCC
CACTTTGCCCTGAGTACTC -> ACTTTGCCCTGAGTACTCC
ACGCCCTCGCGCAGGATGA -> CGCCCTCGCGCAGGATGAA
CATTATCATAACCATACAA -> ATTATCATAACCATACAAA
GTATTGAATGTTACCCTTA -> TATTGAATGTTACCCTTAT
GTCGAGAATTTCGGCATGT -> TCGAGAATTTCGGCATGTT
GAGAAGTATGACTTCGGTA -> AGAAGTATGACTTCGGTAA
TGCGGGTCCACCTAGGGGA -> GCGGGTCCACCTAGGGGAG
TTGTCTGGGAGAGAGCCGG -> TGTCTGGGAGAGAGCCGGT
AGTCCACTCGGAATAGAAT -> GTCCACTCGGAATAGAATG
ACGCCGTGACGACAGTAAG -> CGCCGTGACGACAGTAAGC
GGGGGGAGAAATGCAAAAG -> GGGGGAGAAATGCAAAAGT
TCTCATGCGAACACGCTCA -> CTCATGCGAACACGCTCAG
CTGCGGCTATCGATGAGTG -> TGCGGCTATCGATGAGTGG
CGGCTCGTACAAGTCTACA -> GGCTCGTACAAGTCTACAT
CTGCCACGCTACCCTAGTG -> TGCCACGCTACCCTAGTGC
ACCACAAAGAACTCTACCT -> CCACAAAGAACTCTACCTC
CTAGAACTGTCATATCACT -> TAGAACTGTCATATCACTC
GTGTCAGCGACAAGTGAGC -> TGTCAGCGACAAGTGAGCG
TACGCCTAATGGGATCGAT -> ACGCCTAATGGGATCGATG
GCCAATTGCAACGGTGGTA -> CCAATTGCAACGGTGGTAG
AGAACTCTACCTCGGTGCC -> GAACTCTACCTCGGTGCCA
ACTTCGGTAAGGTTCGGGC -> CTTCGGTAAGGTTCGGGCT
TTGCCAGGGTGGCATTACG -> TGCCAGGGTGGCATTACGC
GAAGGCCCCGCCGGTCACA -> AAGGCCCCGCCGGTCACAC
CCAGTCACGGCTCGTACAA -> CAGTCACGGCTCGTACAAG
GGTAAGGTATCTCTAGGTC -> GTAAGGTATCTCTAGGTCG
TACATCTACCATTCGATAT -> ACATCTACCATTCGATATC
CCGTCGATTCTAGGGCAGC -> CGTCGATTCTAGGGCAGCC
GACTTCGGTAAGGTGGTGT -> ACTTCGGTAAGGTGGTGTA
CATGTCAGTCCTCGTCGAG -> ATGTCAGTCCTCGTCGAGG
AGTGCCGTCCGGAAATAAT -> GTGCCGTCCGGAAATAATC
ATAACTGGGTCAAATATGT -> TAACTGGGTCAAATATGTT
TTCGGTAAGGTATCTCTAG -> TCGGTAAGGTATCTCTAGG
TTACACGACGCCCAGTATA -> TACACGACGCCCAGTATAG
GCTAAGGGCGCTCGACTAT -> CTAAGGGCGCTCGACTATA
TTTCATCAATCTATAGCTG -> TTCATCAATCTATAGCTGA
CGGTGGCGGTTAATTTAAC -> GGTGGCGGTTAATTTAACG
AATAAGTTGCCAGGGTGGC -> ATAAGTTGCCAGGGTGGCA
CCATCCTTTTCCGCTGTTC -> CATCCTTTTCCGCTGTTCG
TCAGCATCGGCACTACATA -> CAGCATCGGCACTACATAG
GGAGAAGTATGACTTCGGT -> GAGAAGTATGACTTCGGTA
AAAAAGCTCTAAATGCGGT -> AAAAGCTCTAAATGCGGTT
TATGACTTCGGTAAGGTCA -> ATGACTTCGGTAAGGTCAT
GGCCCCGCCGGTCACACCC -> GCCCCGCCGGTCACACCCC
TCAGTCCTCGTCGAGGCAG -> CAGTCCTCGTCGAGGCAGT
TCTACCTCGGTGCCAATTG -> CTACCTCGGTGCCAATTGC
TGGGAGAGAGCCGGTTGAG -> GGGAGAGAGCCGGTTGAGA
CTCTTTCACGCATGTGTTT -> TCTTTCACGCATGTGTTTG
TTCGGGCTCCCAGTATTAC -> TCGGGCTCCCAGTATTACG
CCCGTCCCGTCAATTACAC -> CCGTCCCGTCAATTACACG
TTAGAGCCAATGGGGCCTA -> TAGAGCCAATGGGGCCTAC
AGGAGAAGTATGACTTCGG -> GGAGAAGTATGACTTCGGT
TACGCGCCGTATGACTTCG -> ACGCGCCGTATGACTTCGG
AGTGCGCCCGGTATTACGC -> GTGCGCCCGGTATTACGCC
GCCCGGTATTACGCCAGAG -> CCCGGTATTACGCCAGAGG
CCCATCGAGGGGTTAGACC -> CCATCGAGGGGTTAGACCG
CACGACGGCCTTGGCGCAA -> ACGACGGCCTTGGCGCAAA
CACCTCCTGCACGGAACAG -> ACCTCCTGCACGGAACAGG
AAACGGTGGAGTCTCTGGG -> AACGGTGGAGTCTCTGGGT
TCTTCCACCGATTGAATGC -> CTTCCACCGATTGAATGCG
TCAATCTATAGCTGAGCTC -> CAATCTATAGCTGAGCTCT
AGACAGAGGTGACACGAGA -> GACAGAGGTGACACGAGAT
AGGTCGTATTACGCCAGAG -> GGTCGTATTACGCCAGAGG
CATGTTAGAGCCAATGGGG -> ATGTTAGAGCCAATGGGGC
TAAGGTCATTCCGTCAGGT -> AAGGTCATTCCGTCAGGTA
TTTTATAGCTAGGGGGGAG -> TTTATAGCTAGGGGGGAGA
CACCGTATGCTGATTGCCT -> ACCGTATGCTGATTGCCTT
GGGTGCTAGGCTGCTATCT -> GGTGCTAGGCTGCTATCTC
AGACTTACTTTGGGGCTCG -> GACTTACTTTGGGGCTCGG
TGTGCATTGGCGTCGAACA -> GTGCATTGGCGTCGAACAC
TAGGTCGTATTACGCCAGA -> AGGTCGTATTACGCCAGAG
GAAATCTCGACCACAAAGA -> AAATCTCGACCACAAAGAA
TCTAGAACTGTCATATCAC -> CTAGAACTGTCATATCACT
AGCATCGGCACTACATAGG -> GCATCGGCACTACATAGGG
CTAAAAAAAGCTCTAAATG -> TAAAAAAAGCTCTAAATGC
CACACCCGAGATATACCTC -> ACACCCGAGATATACCTCC
TAAGTCCACTCGGAATAGA -> AAGTCCACTCGGAATAGAA
GTGAATTCATCCCTTATTG -> TGAATTCATCCCTTATTGG
TAGGGGGGAGAAATGCAAA -> AGGGGGGAGAAATGCAAAA
TGGCCAGCCGCTAATGTCC -> GGCCAGCCGCTAATGTCCA
CCTCTTGGGTATGACTTCG -> CTCTTGGGTATGACTTCGG
AGGACCGTCATGGAAGGTC -> GGACCGTCATGGAAGGTCC
GGGTGGCATTACGCCGTGA -> GGTGGCATTACGCCGTGAC
CCTATACCGTGCCGAGCAT -> CTATACCGTGCCGAGCATC
CATGAGCACGCATAATAAG -> ATGAGCACGCATAATAAGT
CAAAATCACTTACCTATAT -> AAAATCACTTACCTATATC
CCAACTTTATTGGGAAAGT -> CAACTTTATTGGGAAAGTA
GAGCTGATTAAGAGTTGGA -> AGCTGATTAAGAGTTGGAG
CTTGAAACGGTGGAGTCTC -> TTGAAACGGTGGAGTCTCT
GCCGAGCATCTAGAACTGT -> CCGAGCATCTAGAACTGTC
TAATAAGTATGTCGAGAAT -> AATAAGTATGTCGAGAATT
GAACACCTCCTGCACGGAA -> AACACCTCCTGCACGGAAC
TCAGCGCACCCACGTGAAT -> CAGCGCACCCACGTGAATT
CAAAGTGTATGGAGACAGA -> AAAGTGTATGGAGACAGAG
TGTTGTAACCACCATGAGC -> GTTGTAACCACCATGAGCA
GCATGTTAGAGCCAATGGG -> CATGTTAGAGCCAATGGGG
GTGTCTGGCAAGTCGAGCA -> TGTCTGGCAAGTCGAGCAT
CCAATGGTTGACACGACGG -> CAATGGTTGACACGACGGC
TGTAACCACCATGAGCACG -> GTAACCACCATGAGCACGC
TATGCTAAGGGCGCTCGAC -> ATGCTAAGGGCGCTCGACT
CCAGCCGCTAATGTCCACA -> CAGCCGCTAATGTCCACAC
GCTGCTGCGGCTATCGATG -> CTGCTGCGGCTATCGATGA
ATGTCGAGAATTTCGGCAT -> TGTCGAGAATTTCGGCATG
GCTTGAAGCGTACCCGTCC -> CTTGAAGCGTACCCGTCCC
TTTGTGTCTGGCAAGTCGA -> TTGTGTCTGGCAAGTCGAG
AATAAGTATGTCGAGAATT -> ATAAGTATGTCGAGAATTT
CACCCACGTGAATTCATCC -> ACCCACGTGAATTCATCCC
CTTGCTGTGTGAAGGCCCC -> TTGCTGTGTGAAGGCCCCG
AATCCGCTACGATGCCGAG -> ATCCGCTACGATGCCGAGC
GGCTCGTACAAGTCTACAT -> GCTCGTACAAGTCTACATC
TTGATACCCAAAGCCCGCC -> TGATACCCAAAGCCCGCCA
ATACGTAACGACAGGTGCG -> TACGTAACGACAGGTGCGT
TAGAGACGAGCCTTCACCG -> AGAGACGAGCCTTCACCGT
GACTTACTTTGGGGCTCGG -> ACTTACTTTGGGGCTCGGA
GCGGTTTATTTCTCATGCG -> CGGTTTATTTCTCATGCGA
CCCTAGAGACGAGCCTTCA -> CCTAGAGACGAGCCTTCAC
GACGGCCTTGGCGCAAAAT -> ACGGCCTTGGCGCAAAATA
CCCAGTATAGGCATTATCA -> CCAGTATAGGCATTATCAT
CTGGAATACCCAGGTGGGG -> TGGAATACCCAGGTGGGGT
GGGCGCTCGACTATACGTA -> GGCGCTCGACTATACGTAA
GAACTCCACGATGGGCGTA -> AACTCCACGATGGGCGTAA
GCTTTTCTACACTTTGCCC -> CTTTTCTACACTTTGCCCT
TTCCACCGATTGAATGCGG -> TCCACCGATTGAATGCGGT
ACTGTGAACAATAGGTGAG -> CTGTGAACAATAGGTGAGA
TAGGACATAAACAGGTACG -> AGGACATAAACAGGTACGA
GCTAATGTCCACACCCGAG -> CTAATGTCCACACCCGAGA
ACTCCCATCGAGGGGTTAG -> CTCCCATCGAGGGGTTAGA
AATACCAGACATATGTTCC -> ATACCAGACATATGTTCCG
ACCATTCGATATCTCTCTT -> CCATTCGATATCTCTCTTT
TGTGCTTCCCGACAGGAAG -> GTGCTTCCCGACAGGAAGT
TGCTTCCCGACAGGAAGTC -> GCTTCCCGACAGGAAGTCC
TTGACTTGAAACGGTGGAG -> TGACTTGAAACGGTGGAGT
CGATTGAATGCGGTATGCA -> GATTGAATGCGGTATGCAG
CTGTGAACAATAGGTGAGA -> TGTGAACAATAGGTGAGAA
TGATGGCTTTAGGAGAAGT -> GATGGCTTTAGGAGAAGTA
TGTTCGAGATAGAAGCATT -> GTTCGAGATAGAAGCATTT
CCTAATGGGATCGATGTGA -> CTAATGGGATCGATGTGAT
TAAAAAAAGCTCTAAATGC -> AAAAAAAGCTCTAAATGCG
ATGTTCCGTACAACTCCGA -> TGTTCCGTACAACTCCGAC
TTGCCATCCTTTTCCGCTG -> TGCCATCCTTTTCCGCTGT
GGCGCAAAATACCAGACAT -> GCGCAAAATACCAGACATA
GAGATTCCAGAATGGTGGC -> AGATTCCAGAATGGTGGCC
TATGACTTCGGTAAGGTAT -> ATGACTTCGGTAAGGTATC
TTATTTACGCCTAATGGGA -> TATTTACGCCTAATGGGAT
AATTAAGGGGAGCCGATTG -> ATTAAGGGGAGCCGATTGA
GGGCTCCCAGTATTACGCC -> GGCTCCCAGTATTACGCCA
TCGAGATAGAAGCATTTCG -> CGAGATAGAAGCATTTCGG
ACGAGCCTTCACCGTATGC -> CGAGCCTTCACCGTATGCT
GCAGCCATGTCAGTCCTCG -> CAGCCATGTCAGTCCTCGT
GATATCTCTCTTTCACGCA -> ATATCTCTCTTTCACGCAT
CTCTCTTTCACGCATGTGT -> TCTCTTTCACGCATGTGTT
CTGATTGCCTTTGCCATCC -> TGATTGCCTTTGCCATCCT
GTCCACACCCGAGATATAC -> TCCACACCCGAGATATACC
ATGCGAACACGCTCAGCCC -> TGCGAACACGCTCAGCCCG
AAACAGGTACGATTTTCGA -> AACAGGTACGATTTTCGAC
CCATCACCCCTTTCCAATT -> CATCACCCCTTTCCAATTT
AGAAGTATGACTTCGGTAA -> GAAGTATGACTTCGGTAAG
CTCATGCGAACACGCTCAG -> TCATGCGAACACGCTCAGC
CATCGGCACTACATAGGGT -> ATCGGCACTACATAGGGTT
TACGTAACGACAGGTGCGT -> ACGTAACGACAGGTGCGTG
AATCTCGACCACAAAGAAC -> ATCTCGACCACAAAGAACT
GCAACCTAAGTCCACTCGG -> CAACCTAAGTCCACTCGGA
GAGAATTTCGGCATGTTAG -> AGAATTTCGGCATGTTAGA
TTTAGGAGAAGTATGACTT -> TTAGGAGAAGTATGACTTC
TGAGCTCTTCCACCGATTG -> GAGCTCTTCCACCGATTGA
TGTGAACAATAGGTGAGAA -> GTGAACAATAGGTGAGAAC
GTCTCTGGGTGCTAGGCTG -> TCTCTGGGTGCTAGGCTGC
CCCAGTATTACGCCAGAGG -> CCAGTATTACGCCAGAGGA
GCGTACCCGTCCCGTCAAT -> CGTACCCGTCCCGTCAATT
GTTCGGGCTCCCAGTATTA -> TTCGGGCTCCCAGTATTAC
TGGTAGCCCATTACATCAC -> GGTAGCCCATTACATCACT
GTATGACTTCGGTAAGGTC -> TATGACTTCGGTAAGGTCA
CTTTTCTACACTTTGCCCT -> TTTTCTACACTTTGCCCTG
GCACGGAACAGGCCTTGCT -> CACGGAACAGGCCTTGCTG
TCTACCATTCGATATCTCT -> CTACCATTCGATATCTCTC
AAAGTGCTTGAAGCGTACC -> AAGTGCTTGAAGCGTACCC
AGGTATCTCTAGGTCGTAT -> GGTATCTCTAGGTCGTATT
CCGACAGGAAGTCCGTGGG -> CGACAGGAAGTCCGTGGGT
CCTTCACCGTATGCTGATT -> CTTCACCGTATGCTGATTG
CGACAAGTGAGCGTAGTAC -> GACAAGTGAGCGTAGTACA
CAGTATTACGCCAGAGGAT -> AGTATTACGCCAGAGGATT
CGCAAAATACCAGACATAT -> GCAAAATACCAGACATATG
AAGTACTTTCATCAATCTA -> AGTACTTTCATCAATCTAT
GGTTACACTTGTCTAAAAA -> GTTACACTTGTCTAAAAAA
TGCTGTGTGAAGGCCCCGC -> GCTGTGTGAAGGCCCCGCC
TAAGCCTGGGCTGCCACGC -> AAGCCTGGGCTGCCACGCT
GGGCTCGGAGGTATTGAAT -> GGCTCGGAGGTATTGAATG
GGATTAGTGGTACACTAAT -> GATTAGTGGTACACTAATT
CCACACCCGAGATATACCT -> CACACCCGAGATATACCTC
ATATCTCTCTTTCACGCAT -> TATCTCTCTTTCACGCATG
CTGGGCTGCCACGCTACCC -> TGGGCTGCCACGCTACCCT
CAGTATCCTGTTACTTGGA -> AGTATCCTGTTACTTGGAG
CTTATTGGGCCCCCCTAAA -> TTATTGGGCCCCCCTAAAG
TGGGAAAGTACTTTCATCA -> GGGAAAGTACTTTCATCAA
TACAGTAACTGTCCGTAAG -> ACAGTAACTGTCCGTAAGG
CGCCAGTCACGGCTCGTAC -> GCCAGTCACGGCTCGTACA
GAGCGTAGTACACAAGCTC -> AGCGTAGTACACAAGCTCG
GAATTAAGGGGAGCCGATT -> AATTAAGGGGAGCCGATTG
TATTGAATGTTACCCTTAT -> ATTGAATGTTACCCTTATT
CTAATGGGATCGATGTGAT -> TAATGGGATCGATGTGATT
TACACTAATTGGTGGCAAC -> ACACTAATTGGTGGCAACC
TAAGTTGCCAGGGTGGCAT -> AAGTTGCCAGGGTGGCATT
GGAATAGAATGACACTTGA -> GAATAGAATGACACTTGAG
AACCATACAAAGTGTATGG -> ACCATACAAAGTGTATGGA
CCGGTCACACCCCATAACT -> CGGTCACACCCCATAACTG
CAGGTGGGGTTTGCGCAGC -> AGGTGGGGTTTGCGCAGCT
AGCATTAGGACATAAACAG -> GCATTAGGACATAAACAGG
CGAGGCAGTGCCGTCCGGA -> GAGGCAGTGCCGTCCGGAA
CGTGCCGAGCATCTAGAAC -> GTGCCGAGCATCTAGAACT
ACGCCAGAGGATTATCAGA -> CGCCAGAGGATTATCAGAC
GCCTAATGGGATCGATGTG -> CCTAATGGGATCGATGTGA
CCTGGAATACCCAGGTGGG -> CTGGAATACCCAGGTGGGG
TCGAGGGGTTAGACCGATG -> CGAGGGGTTAGACCGATGT
CCCCCTAAAGTATGCTAAG -> CCCCTAAAGTATGCTAAGG
GAGGATTAGTGCGCCCGGT -> AGGATTAGTGCGCCCGGTA
CACCTAGGGGAGCTGATTA -> ACCTAGGGGAGCTGATTAA
TCGTCCAATGGTTGACACG -> CGTCCAATGGTTGACACGA
TGACTACTCCCATCGAGGG -> GACTACTCCCATCGAGGGG
GCGCAAAATACCAGACATA -> CGCAAAATACCAGACATAT
GCGTAGTACACAAGCTCGC -> CGTAGTACACAAGCTCGCT
TTATAACCATCACCCCTTT -> TATAACCATCACCCCTTTC
CATACAAAGTGTATGGAGA -> ATACAAAGTGTATGGAGAC
GTTAGAGCCAATGGGGCCT -> TTAGAGCCAATGGGGCCTA
CAGGTGCGTGTCAGCGACA -> AGGTGCGTGTCAGCGACAA
GACTGTGCAAGTCAGGGGA -> ACTGTGCAAGTCAGGGGAG
TACTTTGGGGCTCGGAGGT -> ACTTTGGGGCTCGGAGGTA
AGTGCTATTGACTACTCCC -> GTGCTATTGACTACTCCCA
AGACGAGCCTTCACCGTAT -> GACGAGCCTTCACCGTATG
TATAACCATCACCCCTTTC -> ATAACCATCACCCCTTTCC
GTAAGGTTCGGGCTCCCAG -> TAAGGTTCGGGCTCCCAGT
AAGCTCTAAATGCGGTTTA -> AGCTCTAAATGCGGTTTAT
CACGGCTCGTACAAGTCTA -> ACGGCTCGTACAAGTCTAC
TAGAGCCAATGGGGCCTAC -> AGAGCCAATGGGGCCTACG
ACCCACCCTTAGCAAGAAA -> CCCACCCTTAGCAAGAAAT
ATTGAAAACCTCGTTAGCC -> TTGAAAACCTCGTTAGCCG
TTTACGCCTAATGGGATCG -> TTACGCCTAATGGGATCGA
ACAGGCCTTGCTGTGTGAA -> CAGGCCTTGCTGTGTGAAG
TTCCAGAATGGTGGCCAGC -> TCCAGAATGGTGGCCAGCC
CGTACAACTCCGACACATT -> GTACAACTCCGACACATTA
GCATTAGGACATAAACAGG -> CATTAGGACATAAACAGGT
CTAATGTCCACACCCGAGA -> TAATGTCCACACCCGAGAT
ACCATGAGCACGCATAATA -> CCATGAGCACGCATAATAA
GACATATGTTCCGTACAAC -> ACATATGTTCCGTACAACT
GTTAGACCGATGTTTCCGA -> TTAGACCGATGTTTCCGAT
AGGTATTGAATGTTACCCT -> GGTATTGAATGTTACCCTT
AATGTCCACACCCGAGATA -> ATGTCCACACCCGAGATAT
GTCACGGCTCGTACAAGTC -> TCACGGCTCGTACAAGTCT
ATGTTGTAACCACCATGAG -> TGTTGTAACCACCATGAGC
TCGATATCTCTCTTTCACG -> CGATATCTCTCTTTCACGC
ATGACTTCGGTAAGGTATC -> TGACTTCGGTAAGGTATCT
TAAAGTATGCTAAGGGCGC -> AAAGTATGCTAAGGGCGCT
TTCGGCATGTTAGAGCCAA -> TCGGCATGTTAGAGCCAAT
GTGGTGTGCTTCCCGACAG -> TGGTGTGCTTCCCGACAGG
GACACGAGATTCCAGAATG -> ACACGAGATTCCAGAATGG
GTGGCAACCTAAGTCCACT -> TGGCAACCTAAGTCCACTC
AGTACTTTCATCAATCTAT -> GTACTTTCATCAATCTATA
CTGCGAGACTTACTTTGGG -> TGCGAGACTTACTTTGGGG
CCATGCTGCTGCGGCTATC -> CATGCTGCTGCGGCTATCG
ATACCAGTATCCTGTTACT -> TACCAGTATCCTGTTACTT
AAGCCCGCCAGTCACGGCT -> AGCCCGCCAGTCACGGCTC
CAATGATGGCTTTAGGAGA -> AATGATGGCTTTAGGAGAA
GGGGGAGAAATGCAAAAGT -> GGGGAGAAATGCAAAAGTG
GTCCACCTAGGGGAGCTGA -> TCCACCTAGGGGAGCTGAT
CTACACTTTGCCCTGAGTA -> TACACTTTGCCCTGAGTAC
AAGTATGTCGAGAATTTCG -> AGTATGTCGAGAATTTCGG
ACGCCTAATGGGATCGATG -> CGCCTAATGGGATCGATGT
TTTCTACACTTTGCCCTGA -> TTCTACACTTTGCCCTGAG
AGTCACGGCTCGTACAAGT -> GTCACGGCTCGTACAAGTC
TGGTGGCAACCTAAGTCCA -> GGTGGCAACCTAAGTCCAC
AGAACTGTCATATCACTCA -> GAACTGTCATATCACTCAG
TTGTGTCTGGCAAGTCGAG -> TGTGTCTGGCAAGTCGAGC
GTTACTTGGAGCTACGCGC -> TTACTTGGAGCTACGCGCC
GGGGAGAAATGCAAAAGTG -> GGGAGAAATGCAAAAGTGC
GTATTACGCCAGAGGATTA -> TATTACGCCAGAGGATTAG,TATTACGCCAGAGGATTAT,TATTACGCCAGAGGATTAT,TATTACGCCAGAGGATTAG
TTTGAACGAAGTTCAGTCA -> TTGAACGAAGTTCAGTCAA
TGTTCCGTACAACTCCGAC -> GTTCCGTACAACTCCGACA
GTATCCTGTTACTTGGAGC -> TATCCTGTTACTTGGAGCT
TGCGCCCGGTATTACGCCA -> GCGCCCGGTATTACGCCAG
CAAGTGAGCGTAGTACACA -> AAGTGAGCGTAGTACACAA
ACAGGTACGATTTTCGACC -> CAGGTACGATTTTCGACCC
TCGTCGAGGCAGTGCCGTC -> CGTCGAGGCAGTGCCGTCC
ATGGGCGTAAGTATACAGT -> TGGGCGTAAGTATACAGTA
CGGTGGTAGCCCATTACAT -> GGTGGTAGCCCATTACATC
ATGCGGTATGCAGTTTTAT -> TGCGGTATGCAGTTTTATA
GCTGCCACGCTACCCTAGT -> CTGCCACGCTACCCTAGTG
CACTAATTGGTGGCAACCT -> ACTAATTGGTGGCAACCTA
ATTACGCCAGAGGATTAGT -> TTACGCCAGAGGATTAGTG,TTACGCCAGAGGATTAGTG
TGATTGAAAACCTCGTTAG -> GATTGAAAACCTCGTTAGC
ACATATGTTCCGTACAACT -> CATATGTTCCGTACAACTC
AACAGGCCTTGCTGTGTGA -> ACAGGCCTTGCTGTGTGAA
CATTAGGACATAAACAGGT -> ATTAGGACATAAACAGGTA
TCAATCCGCTACGATGCCG -> CAATCCGCTACGATGCCGA
GGGGAGCCGATTGACTTGA -> GGGAGCCGATTGACTTGAA
AAAGCTCTAAATGCGGTTT -> AAGCTCTAAATGCGGTTTA
ACCTCCAGTGGGTCATCCC -> CCTCCAGTGGGTCATCCCA
GATTGAAAACCTCGTTAGC -> ATTGAAAACCTCGTTAGCC
ATATCACTCAGCATCGGCA -> TATCACTCAGCATCGGCAC
GTTGTCTGGGAGAGAGCCG -> TTGTCTGGGAGAGAGCCGG
CTACCCTAGTGCTATTGAC -> TACCCTAGTGCTATTGACT
ACCTCGTTAGCCGAGAGGA -> CCTCGTTAGCCGAGAGGAT
ATTTCGGCATGTTAGAGCC -> TTTCGGCATGTTAGAGCCA
GGTGACACGAGATTCCAGA -> GTGACACGAGATTCCAGAA
CCGTCCCGTCAATTACACG -> CGTCCCGTCAATTACACGA
TTTTCGACCCGTGACTTTG -> TTTCGACCCGTGACTTTGA
CCCGACAGGAAGTCCGTGG -> CCGACAGGAAGTCCGTGGG
TATTACGCCAGAGGATTAG -> ATTACGCCAGAGGATTAGT,ATTACGCCAGAGGATTAGT
TACCTATATCAGCGCACCC -> ACCTATATCAGCGCACCCA
CGTCGATTCTAGGGCAGCC -> GTCGATTCTAGGGCAGCCA
GACTTTGATCACGCCCTTA -> ACTTTGATCACGCCCTTAG
AGCTGATTAAGAGTTGGAG -> GCTGATTAAGAGTTGGAGA
AGGGGAGCTGATTAAGAGT -> GGGGAGCTGATTAAGAGTT
AAATGCAAAAGTGCTTGAA -> AATGCAAAAGTGCTTGAAG
ATGACTTCGGTAAGGTCAT -> TGACTTCGGTAAGGTCATT
TCCTCGTCGAGGCAGTGCC -> CCTCGTCGAGGCAGTGCCG
TGAGACAAAATCACTTACC -> GAGACAAAATCACTTACCT
ATAAGTATGTCGAGAATTT -> TAAGTATGTCGAGAATTTC
GAGAGGATCCATGCTGCTG -> AGAGGATCCATGCTGCTGC
CTCCACGATGGGCGTAAGT -> TCCACGATGGGCGTAAGTA
ACGGTGGTAGCCCATTACA -> CGGTGGTAGCCCATTACAT
GTTCAGTCAAAACCCACCC -> TTCAGTCAAAACCCACCCT
CGCCGTATGACTTCGGTAA -> GCCGTATGACTTCGGTAAG
CAGCCCGTGCGGGTCCACC -> AGCCCGTGCGGGTCCACCT
CAACAGCACACATGTGCAT -> AACAGCACACATGTGCATT
GCCGTATGACTTCGGTAAG -> CCGTATGACTTCGGTAAGG
CAAAATACCAGACATATGT -> AAAATACCAGACATATGTT
ACTTACTTTGGGGCTCGGA -> CTTACTTTGGGGCTCGGAG
GACATAAACAGGTACGATT -> ACATAAACAGGTACGATTT
TCTGGGTGCTAGGCTGCTA -> CTGGGTGCTAGGCTGCTAT
AACGAAGTTCAGTCAAAAC -> ACGAAGTTCAGTCAAAACC
GGGAGAGAGCCGGTTGAGA -> GGAGAGAGCCGGTTGAGAC
CATAACTGGGTCAAATATG -> ATAACTGGGTCAAATATGT
CTGGGAGAGAGCCGGTTGA -> TGGGAGAGAGCCGGTTGAG
TGGCAAGTCGAGCATTAGG -> GGCAAGTCGAGCATTAGGA
GGCATTACGCCGTGACGAC -> GCATTACGCCGTGACGACA
AGGTTCGGGCTCCCAGTAT -> GGTTCGGGCTCCCAGTATT
TTCAATCCGCTACGATGCC -> TCAATCCGCTACGATGCCG
TCAGGGGAGGACCGTCATG -> CAGGGGAGGACCGTCATGG
CAATTGCAACGGTGGTAGC -> AATTGCAACGGTGGTAGCC
AAGTCTACATCTACCATTC -> AGTCTACATCTACCATTCG
AATGCGGTTTATTTCTCAT -> ATGCGGTTTATTTCTCATG
GTATGACTTCGGTAAGGTA -> TATGACTTCGGTAAGGTAT
ACGCCAACAGCACACATGT -> CGCCAACAGCACACATGTG
TTTCTCATGCGAACACGCT -> TTCTCATGCGAACACGCTC
GAGACAAAATCACTTACCT -> AGACAAAATCACTTACCTA
GACGGCCTCGATGTTGTAA -> ACGGCCTCGATGTTGTAAC
TACCCAGGTGGGGTTTGCG -> ACCCAGGTGGGGTTTGCGC
TAGAAGCATTTCGGAGATG -> AGAAGCATTTCGGAGATGA
AATGCAAAAGTGCTTGAAG -> ATGCAAAAGTGCTTGAAGC
CTTTCCAATTTTAACCTAT -> TTTCCAATTTTAACCTATA
GCCAGTCACGGCTCGTACA -> CCAGTCACGGCTCGTACAA
TTAGGAGAAGTATGACTTC -> TAGGAGAAGTATGACTTCG
CGACCACAAAGAACTCTAC -> GACCACAAAGAACTCTACC
AGAGCCGGTTGAGACAAAA -> GAGCCGGTTGAGACAAAAT
CTTTGCCCTGAGTACTCCA -> TTTGCCCTGAGTACTCCAA
TCGATGTTGTAACCACCAT -> CGATGTTGTAACCACCATG
TTTGCCATCCTTTTCCGCT -> TTGCCATCCTTTTCCGCTG
AGCTTTGCCCTCTTGGGTA -> GCTTTGCCCTCTTGGGTAT
AGAGGATTATAACCATCAC -> GAGGATTATAACCATCACC
GCCAGAGGATTAGTGGTAC -> CCAGAGGATTAGTGGTACA
CGGCACTACATAGGGTTAC -> GGCACTACATAGGGTTACA
ATTTCTCATGCGAACACGC -> TTTCTCATGCGAACACGCT
TACCAGTATCCTGTTACTT -> ACCAGTATCCTGTTACTTG
GGAAATAATCTCATTGGTT -> GAAATAATCTCATTGGTTG
TTACGCCAGAGGATTATAA -> TACGCCAGAGGATTATAAC
ACAAGTCTACATCTACCAT -> CAAGTCTACATCTACCATT
TGTCATATCACTCAGCATC -> GTCATATCACTCAGCATCG
GTTCGAGATAGAAGCATTT -> TTCGAGATAGAAGCATTTC
CGAACACCTCCTGCACGGA -> GAACACCTCCTGCACGGAA
GGTATACCAGTATCCTGTT -> GTATACCAGTATCCTGTTA
GGATTAGTGCGCCCGGTAT -> GATTAGTGCGCCCGGTATT
TTGGGTATGACTTCGGTAA -> TGGGTATGACTTCGGTAAG
CTCGGACCCTAGAGACGAG -> TCGGACCCTAGAGACGAGC
GACACATTATTTACGCCTA -> ACACATTATTTACGCCTAA
GTGCCAATTGCAACGGTGG -> TGCCAATTGCAACGGTGGT
ACAAGTGAGCGTAGTACAC -> CAAGTGAGCGTAGTACACA
CGGCCTTGGCGCAAAATAC -> GGCCTTGGCGCAAAATACC
CTAATTGGTGGCAACCTAA -> TAATTGGTGGCAACCTAAG
CGTCCCGTCAATTACACGA -> GTCCCGTCAATTACACGAC
CAAAACCCACCCTTAGCAA -> AAAACCCACCCTTAGCAAG
TTAGGACATAAACAGGTAC -> TAGGACATAAACAGGTACG
GTCCTGGAATACCCAGGTG -> TCCTGGAATACCCAGGTGG
AAAACCCACCCTTAGCAAG -> AAACCCACCCTTAGCAAGA
ATTGCAACGGTGGTAGCCC -> TTGCAACGGTGGTAGCCCA
CTTCCCGACAGGAAGTCCG -> TTCCCGACAGGAAGTCCGT
GTCACCGCTACGTTGTCTG -> TCACCGCTACGTTGTCTGG
AGCGAATTAAGGGGAGCCG -> GCGAATTAAGGGGAGCCGA
TTGTCTAAAAAAAGCTCTA -> TGTCTAAAAAAAGCTCTAA
GGACCGTCATGGAAGGTCC -> GACCGTCATGGAAGGTCCT
GGTTAGACCGATGTTTCCG -> GTTAGACCGATGTTTCCGA
GATGGGCGTAAGTATACAG -> ATGGGCGTAAGTATACAGT
GCTACGATGCCGAGCTGGA -> CTACGATGCCGAGCTGGAC
GAAAACCTCGTTAGCCGAG -> AAAACCTCGTTAGCCGAGA
ACGGTGGAGTCTCTGGGTG -> CGGTGGAGTCTCTGGGTGC
GAAGGTCCTGGAATACCCA -> AAGGTCCTGGAATACCCAG
ATGAGCACGCATAATAAGT -> TGAGCACGCATAATAAGTA
GCCCCCCTAAAGTATGCTA -> CCCCCCTAAAGTATGCTAA
TAAGGAGTACGACTGTGCA -> AAGGAGTACGACTGTGCAA
CCAGAGGATTAGTGCGCCC -> CAGAGGATTAGTGCGCCCG
ATTCTAGGGCAGCCATGTC -> TTCTAGGGCAGCCATGTCA
CTTCGGTAAGGTATCTCTA -> TTCGGTAAGGTATCTCTAG
GTAAGTATACAGTAACTGT -> TAAGTATACAGTAACTGTC
TGCGGTATGCAGTTTTATA -> GCGGTATGCAGTTTTATAG
GCAAGTCAGGGGAGGACCG -> CAAGTCAGGGGAGGACCGT
CAAGAAATCTCGACCACAA -> AAGAAATCTCGACCACAAA
AGCAAGAAATCTCGACCAC -> GCAAGAAATCTCGACCACA
CATGTGTTTGAACGAAGTT -> ATGTGTTTGAACGAAGTTC
AGTCTCTGGGTGCTAGGCT -> GTCTCTGGGTGCTAGGCTG
TATCAGCGCACCCACGTGA -> ATCAGCGCACCCACGTGAA
CCGAGCTGGACGCCAACAG -> CGAGCTGGACGCCAACAGC
GACACTTGAGGTCACCGCT -> ACACTTGAGGTCACCGCTA
CTCGCTTTTCTACACTTTG -> TCGCTTTTCTACACTTTGC
GGGCTGCCACGCTACCCTA -> GGCTGCCACGCTACCCTAG
GTATGTCGAGAATTTCGGC -> TATGTCGAGAATTTCGGCA
CCAACAGCACACATGTGCA -> CAACAGCACACATGTGCAT
TCATGCGAACACGCTCAGC -> CATGCGAACACGCTCAGCC
GTCATGGAAGGTCCTGGAA -> TCATGGAAGGTCCTGGAAT
GTCCACTCGGAATAGAATG -> TCCACTCGGAATAGAATGA
ATAAGTTGCCAGGGTGGCA -> TAAGTTGCCAGGGTGGCAT
CTTATTAATTGATACCCAA -> TTATTAATTGATACCCAAA
GCTATCTCTGCGAGACTTA -> CTATCTCTGCGAGACTTAC
TTAGACCGATGTTTCCGAT -> TAGACCGATGTTTCCGATT
ACACTTTGCCCTGAGTACT -> CACTTTGCCCTGAGTACTC
TGGAGACGGCCTCGATGTT -> GGAGACGGCCTCGATGTTG
AGCCCGTGCGGGTCCACCT -> GCCCGTGCGGGTCCACCTA
TACCTCGGTGCCAATTGCA -> ACCTCGGTGCCAATTGCAA
ATAGCTGAGCTCTTCCACC -> TAGCTGAGCTCTTCCACCG
AACGACAGGTGCGTGTCAG -> ACGACAGGTGCGTGTCAGC
GCGGTGGCGGTTAATTTAA -> CGGTGGCGGTTAATTTAAC
CTTGGAGCTACGCGCCGTA -> TTGGAGCTACGCGCCGTAT
AGGTGGTGTATGACTTCGG -> GGTGGTGTATGACTTCGGT
TAGCCGAGAGGATCCATGC -> AGCCGAGAGGATCCATGCT
CACCCCTTTCCAATTTTAA -> ACCCCTTTCCAATTTTAAC
TGAGTGGTGTGCTTCCCGA -> GAGTGGTGTGCTTCCCGAC
GTACGACTGTGCAAGTCAG -> TACGACTGTGCAAGTCAGG
GGCTGCCACGCTACCCTAG -> GCTGCCACGCTACCCTAGT
ATCCTTTTCCGCTGTTCGA -> TCCTTTTCCGCTGTTCGAG
GAGAACTCCACGATGGGCG -> AGAACTCCACGATGGGCGT
CGCCGGTCACACCCCATAA -> GCCGGTCACACCCCATAAC
TGGGCTGCCACGCTACCCT -> GGGCTGCCACGCTACCCTA
GGGGTTTGCGCAGCTCGAT -> GGGTTTGCGCAGCTCGATC
TTACCCTTATTAATTGATA -> TACCCTTATTAATTGATAC
TCCACCTAGGGGAGCTGAT -> CCACCTAGGGGAGCTGATT
ACTTGAGGTCACCGCTACG -> CTTGAGGTCACCGCTACGT
ACATAGGGTTACACTTGTC -> CATAGGGTTACACTTGTCT
CCCCCCTAAAGTATGCTAA -> CCCCCTAAAGTATGCTAAG
CGTGAATTCATCCCTTATT -> GTGAATTCATCCCTTATTG
ATTATTTACGCCTAATGGG -> TTATTTACGCCTAATGGGA
CTAAGTCCACTCGGAATAG -> TAAGTCCACTCGGAATAGA
TACTCGGACCCTAGAGACG -> ACTCGGACCCTAGAGACGA
GTGGGGTTTGCGCAGCTCG -> TGGGGTTTGCGCAGCTCGA
TAGGGCAGCCATGTCAGTC -> AGGGCAGCCATGTCAGTCC
TGCCGTCCGGAAATAATCT -> GCCGTCCGGAAATAATCTC
GGTCACCGCTACGTTGTCT -> GTCACCGCTACGTTGTCTG
GGCAGTGCCGTCCGGAAAT -> GCAGTGCCGTCCGGAAATA
CAACTCCGACACATTATTT -> AACTCCGACACATTATTTA
TGCGCAGCTCGATCACGCC -> GCGCAGCTCGATCACGCCC
GAAATGCAAAAGTGCTTGA -> AAATGCAAAAGTGCTTGAA
CCAGCGAATTAAGGGGAGC -> CAGCGAATTAAGGGGAGCC
TAATTGATACCCAAAGCCC -> AATTGATACCCAAAGCCCG
CGCCCTCGCGCAGGATGAA -> GCCCTCGCGCAGGATGAAA
CCGAGAGGATCCATGCTGC -> CGAGAGGATCCATGCTGCT
GTCCTCGTCGAGGCAGTGC -> TCCTCGTCGAGGCAGTGCC
ATCACTCAGCATCGGCACT -> TCACTCAGCATCGGCACTA
TTGGTTGGTAAGCCTGGGC -> TGGTTGGTAAGCCTGGGCT
TATAGGCATTATCATAACC -> ATAGGCATTATCATAACCA
TACCCTTATTAATTGATAC -> ACCCTTATTAATTGATACC
CATTCGATATCTCTCTTTC -> ATTCGATATCTCTCTTTCA
CGAAGTTCAGTCAAAACCC -> GAAGTTCAGTCAAAACCCA
CCCCGCCGGTCACACCCCA -> CCCGCCGGTCACACCCCAT
GAGTACTCCAATGATGGCT -> AGTACTCCAATGATGGCTT
AGCCTTCACCGTATGCTGA -> GCCTTCACCGTATGCTGAT
AGTGAGCGTAGTACACAAG -> GTGAGCGTAGTACACAAGC
GTGGTACACTAATTGGTGG -> TGGTACACTAATTGGTGGC
GAAATAATCTCATTGGTTG -> AAATAATCTCATTGGTTGG
TGCAACGGTGGTAGCCCAT -> GCAACGGTGGTAGCCCATT
GGGTATGACTTCGGTAAGG -> GGTATGACTTCGGTAAGGT
CCACGCTACCCTAGTGCTA -> CACGCTACCCTAGTGCTAT
TTGAGACAAAATCACTTAC -> TGAGACAAAATCACTTACC
AAACCTCGTTAGCCGAGAG -> AACCTCGTTAGCCGAGAGG
TGGCGGTTAATTTAACGCG -> GGCGGTTAATTTAACGCGT
GGTACACTAATTGGTGGCA -> GTACACTAATTGGTGGCAA
ATCTCATTGGTTGGTAAGC -> TCTCATTGGTTGGTAAGCC
AGTCCGTGGGTATACCAGT -> GTCCGTGGGTATACCAGTA
TGAAATAAGTTGCCAGGGT -> GAAATAAGTTGCCAGGGTG
GCCCGCCAGTCACGGCTCG -> CCCGCCAGTCACGGCTCGT
GTGCCGTCCGGAAATAATC -> TGCCGTCCGGAAATAATCT
GCAGTGCCGTCCGGAAATA -> CAGTGCCGTCCGGAAATAA
GAACTGTCATATCACTCAG -> AACTGTCATATCACTCAGC
TTACCTTTGTGTCTGGCAA -> TACCTTTGTGTCTGGCAAG
CGAGAATTTCGGCATGTTA -> GAGAATTTCGGCATGTTAG
AAAAGCTCTAAATGCGGTT -> AAAGCTCTAAATGCGGTTT
CCTAAGTCCACTCGGAATA -> CTAAGTCCACTCGGAATAG
ACCGCTACGTTGTCTGGGA -> CCGCTACGTTGTCTGGGAG
CGGTGCCAATTGCAACGGT -> GGTGCCAATTGCAACGGTG
ACTTTGGGGCTCGGAGGTA -> CTTTGGGGCTCGGAGGTAT
TTGACACGACGGCCTTGGC -> TGACACGACGGCCTTGGCG
TCGATGTGATTGAAAACCT -> CGATGTGATTGAAAACCTC
CGATGTTTCCGATTACCTT -> GATGTTTCCGATTACCTTT
CATAACCATACAAAGTGTA -> ATAACCATACAAAGTGTAT
GACGAGCCTTCACCGTATG -> ACGAGCCTTCACCGTATGC
GAATAGAATGACACTTGAG -> AATAGAATGACACTTGAGG
GCTCGATCACGCCCTCGCG -> CTCGATCACGCCCTCGCGC
CAAGCTCGCTTTTCTACAC -> AAGCTCGCTTTTCTACACT
TCTCATTGGTTGGTAAGCC -> CTCATTGGTTGGTAAGCCT
ACGACGGCCTTGGCGCAAA -> CGACGGCCTTGGCGCAAAA
CGCATAATAAGTATGTCGA -> GCATAATAAGTATGTCGAG
TCTATAGCTGAGCTCTTCC -> CTATAGCTGAGCTCTTCCA
ACGTGAATTCATCCCTTAT -> CGTGAATTCATCCCTTATT
ATCGTCCAATGGTTGACAC -> TCGTCCAATGGTTGACACG
CGAACACGCTCAGCCCGTG -> GAACACGCTCAGCCCGTGC
ATGCAAAAGTGCTTGAAGC -> TGCAAAAGTGCTTGAAGCG
AGTAACTGTCCGTAAGGAG -> GTAACTGTCCGTAAGGAGT
CCATGTCAGTCCTCGTCGA -> CATGTCAGTCCTCGTCGAG
ATTATCATAACCATACAAA -> TTATCATAACCATACAAAG
TTTAACGCGTTCAATCCGC -> TTAACGCGTTCAATCCGCT
CAGGTATTACGCCAGAGGA -> AGGTATTACGCCAGAGGAT
GTATAGGCATTATCATAAC -> TATAGGCATTATCATAACC
CTATACGTAACGACAGGTG -> TATACGTAACGACAGGTGC
TAAGGGGAGCCGATTGACT -> AAGGGGAGCCGATTGACTT
GTGGGTCATCCCAGCGAAT -> TGGGTCATCCCAGCGAATT
CCACAAAGAACTCTACCTC -> CACAAAGAACTCTACCTCG
CGCCAGAGGATTAGTGGTA -> GCCAGAGGATTAGTGGTAC
AAGGGCGCTCGACTATACG -> AGGGCGCTCGACTATACGT
TCTAAATGCGGTTTATTTC -> CTAAATGCGGTTTATTTCT
CCGAGCATCTAGAACTGTC -> CGAGCATCTAGAACTGTCA
ACCCAAAGCCCGCCAGTCA -> CCCAAAGCCCGCCAGTCAC
AGCACACATGTGCATTGGC -> GCACACATGTGCATTGGCG
TCCAATTTTAACCTATACC -> CCAATTTTAACCTATACCG
AGCTACGCGCCGTATGACT -> GCTACGCGCCGTATGACTT
TGAAAACCTCGTTAGCCGA -> GAAAACCTCGTTAGCCGAG
ATGGCTTTAGGAGAAGTAT -> TGGCTTTAGGAGAAGTATG
ATGCAGTTTTATAGCTAGG -> TGCAGTTTTATAGCTAGGG
ACTTACCTATATCAGCGCA -> CTTACCTATATCAGCGCAC
AGCTAGGGGGGAGAAATGC -> GCTAGGGGGGAGAAATGCA
ATCGATGAGTGGTGTGCTT -> TCGATGAGTGGTGTGCTTC
GTCAGCGACAAGTGAGCGT -> TCAGCGACAAGTGAGCGTA
CCACCATGAGCACGCATAA -> CACCATGAGCACGCATAAT
TAAGCCAACTTTATTGGGA -> AAGCCAACTTTATTGGGAA
GCGTTCAATCCGCTACGAT -> CGTTCAATCCGCTACGATG
CACGACGCCCAGTATAGGC -> ACGACGCCCAGTATAGGCA
CCCTTAGCTTTGCCCTCTT -> CCTTAGCTTTGCCCTCTTG
TAGGCATTATCATAACCAT -> AGGCATTATCATAACCATA
TGGGGCTCGGAGGTATTGA -> GGGGCTCGGAGGTATTGAA
AGGTGGGGTTTGCGCAGCT -> GGTGGGGTTTGCGCAGCTC
CTATCGATGAGTGGTGTGC -> TATCGATGAGTGGTGTGCT
CTTTAGGAGAAGTATGACT -> TTTAGGAGAAGTATGACTT
ATAGGCATTATCATAACCA -> TAGGCATTATCATAACCAT
AGTATGCTAAGGGCGCTCG -> GTATGCTAAGGGCGCTCGA
ATTGAATGCGGTATGCAGT -> TTGAATGCGGTATGCAGTT
CGTACAAGTCTACATCTAC -> GTACAAGTCTACATCTACC
TTTGCGCAGCTCGATCACG -> TTGCGCAGCTCGATCACGC
AACTCCGACACATTATTTA -> ACTCCGACACATTATTTAC
GTGCGTGTCAGCGACAAGT -> TGCGTGTCAGCGACAAGTG
AATACCCAGGTGGGGTTTG -> ATACCCAGGTGGGGTTTGC
AGCTCTTCCACCGATTGAA -> GCTCTTCCACCGATTGAAT
GTGGGTATACCAGTATCCT -> TGGGTATACCAGTATCCTG
TCATATCACTCAGCATCGG -> CATATCACTCAGCATCGGC
GCTGAGCTCTTCCACCGAT -> CTGAGCTCTTCCACCGATT
AGTCTACATCTACCATTCG -> GTCTACATCTACCATTCGA
TGCAAAAGTGCTTGAAGCG -> GCAAAAGTGCTTGAAGCGT
ATTTACGCCTAATGGGATC -> TTTACGCCTAATGGGATCG
GATGACATGATCGTCCAAT -> ATGACATGATCGTCCAATG
AATGGTTGACACGACGGCC -> ATGGTTGACACGACGGCCT
CATCACTAGCCGTCGATTC -> ATCACTAGCCGTCGATTCT
GCCAGAGGATTATAACCAT -> CCAGAGGATTATAACCATC
ACACATTATTTACGCCTAA -> CACATTATTTACGCCTAAT
GCGACAAGTGAGCGTAGTA -> CGACAAGTGAGCGTAGTAC
CTTCGGTAAGGTCATTCCG -> TTCGGTAAGGTCATTCCGT
GGCAACCTAAGTCCACTCG -> GCAACCTAAGTCCACTCGG
TCCCAGCGAATTAAGGGGA -> CCCAGCGAATTAAGGGGAG
AATGGGATCGATGTGATTG -> ATGGGATCGATGTGATTGA
CCGTATGACTTCGGTAAGG -> CGTATGACTTCGGTAAGGT
CGGTGGAGTCTCTGGGTGC -> GGTGGAGTCTCTGGGTGCT
CGATGGGCGTAAGTATACA -> GATGGGCGTAAGTATACAG
CAGGGGAGGACCGTCATGG -> AGGGGAGGACCGTCATGGA
GTCAGGTATTACGCCAGAG -> TCAGGTATTACGCCAGAGG
AAATCACTTACCTATATCA -> AATCACTTACCTATATCAG
ATGTGATTGAAAACCTCGT -> TGTGATTGAAAACCTCGTT
GCACTACATAGGGTTACAC -> CACTACATAGGGTTACACT
CCTCCAGTGGGTCATCCCA -> CTCCAGTGGGTCATCCCAG
ATATACCTCCAGTGGGTCA -> TATACCTCCAGTGGGTCAT
CGGTAAGGTGGTGTATGAC -> GGTAAGGTGGTGTATGACT
GTACGATTTTCGACCCGTG -> TACGATTTTCGACCCGTGA
GGTCACACCCCATAACTGG -> GTCACACCCCATAACTGGG
TCAAAACCCACCCTTAGCA -> CAAAACCCACCCTTAGCAA
TGCCGAGCTGGACGCCAAC -> GCCGAGCTGGACGCCAACA
GTTAATTTAACGCGTTCAA -> TTAATTTAACGCGTTCAAT
AAGTCCACTCGGAATAGAA -> AGTCCACTCGGAATAGAAT
CACGAGATTCCAGAATGGT -> ACGAGATTCCAGAATGGTG
CGGTATGCAGTTTTATAGC -> GGTATGCAGTTTTATAGCT
ATTCCAGAATGGTGGCCAG -> TTCCAGAATGGTGGCCAGC
AACCATCACCCCTTTCCAA -> ACCATCACCCCTTTCCAAT
CTTTCATCAATCTATAGCT -> TTTCATCAATCTATAGCTG
TACTCCCATCGAGGGGTTA -> ACTCCCATCGAGGGGTTAG
ACACGACGCCCAGTATAGG -> CACGACGCCCAGTATAGGC
TTTCCGATTACCTTTGTGT -> TTCCGATTACCTTTGTGTC
CGACGGCCTTGGCGCAAAA -> GACGGCCTTGGCGCAAAAT
GCAGGATGAAATAAGTTGC -> CAGGATGAAATAAGTTGCC
ACTACATAGGGTTACACTT -> CTACATAGGGTTACACTTG
AACCCACCCTTAGCAAGAA -> ACCCACCCTTAGCAAGAAA
CGTGGGTATACCAGTATCC -> GTGGGTATACCAGTATCCT
TGGGCCCCCCTAAAGTATG -> GGGCCCCCCTAAAGTATGC
TTTAACCTATACCGTGCCG -> TTAACCTATACCGTGCCGA
GGACGCCAACAGCACACAT -> GACGCCAACAGCACACATG
TACCTTTGTGTCTGGCAAG -> ACCTTTGTGTCTGGCAAGT
ATCTAGAACTGTCATATCA -> TCTAGAACTGTCATATCAC
TAGCCGTCGATTCTAGGGC -> AGCCGTCGATTCTAGGGCA
CAGCCATGTCAGTCCTCGT -> AGCCATGTCAGTCCTCGTC
TTAATTGATACCCAAAGCC -> TAATTGATACCCAAAGCCC
TTGCCTTTGCCATCCTTTT -> TGCCTTTGCCATCCTTTTC
GTGGTAGCCCATTACATCA -> TGGTAGCCCATTACATCAC
TAATCTCATTGGTTGGTAA -> AATCTCATTGGTTGGTAAG
TTGAAACGGTGGAGTCTCT -> TGAAACGGTGGAGTCTCTG
GTTAGCCGAGAGGATCCAT -> TTAGCCGAGAGGATCCATG
GCATTATCATAACCATACA -> CATTATCATAACCATACAA
CTCTACCTCGGTGCCAATT -> TCTACCTCGGTGCCAATTG
GTGAAGGCCCCGCCGGTCA -> TGAAGGCCCCGCCGGTCAC
GGGGTTAGACCGATGTTTC -> GGGTTAGACCGATGTTTCC
GCCAGAGGATTATCAGACT -> CCAGAGGATTATCAGACTG
CAGAGGATTATCAGACTGT -> AGAGGATTATCAGACTGTG
TCATTCCGTCAGGTATTAC -> CATTCCGTCAGGTATTACG
TATCCTGTTACTTGGAGCT -> ATCCTGTTACTTGGAGCTA
TATCGATGAGTGGTGTGCT -> ATCGATGAGTGGTGTGCTT
CCAATGATGGCTTTAGGAG -> CAATGATGGCTTTAGGAGA
CAGGTACGATTTTCGACCC -> AGGTACGATTTTCGACCCG
GTGATTGAAAACCTCGTTA -> TGATTGAAAACCTCGTTAG
GGAGTACGACTGTGCAAGT -> GAGTACGACTGTGCAAGTC
CTTCCACCGATTGAATGCG -> TTCCACCGATTGAATGCGG
GAGCATTAGGACATAAACA -> AGCATTAGGACATAAACAG
CACAAGCTCGCTTTTCTAC -> ACAAGCTCGCTTTTCTACA
TCGAGCATTAGGACATAAA -> CGAGCATTAGGACATAAAC
TAGGGGAGCTGATTAAGAG -> AGGGGAGCTGATTAAGAGT
CAAGTCTACATCTACCATT -> AAGTCTACATCTACCATTC
ACGCGTTCAATCCGCTACG -> CGCGTTCAATCCGCTACGA
TCGTTAGCCGAGAGGATCC -> CGTTAGCCGAGAGGATCCA
CAGCTCGATCACGCCCTCG -> AGCTCGATCACGCCCTCGC
